bacru	$x_{1}$ utters verbally/says/phonates/speaks [vocally makes sound] $x_{2}$.
badna	$x_{1}$ is a banana/plantain [fruit/plant] of species/breed $x_{2}$.
badri	$x_{1}$ is sad/depressed/dejected/[unhappy/feels sorrow/grief] about $x_{2}$ (abstraction).
bajra	$x_{1}$ runs on surface $x_{2}$ using limbs $x_{3}$ with gait $x_{4}$.
bakfu	$x_{1}$ is a bundle/package/cluster/clump/pack [shape/form] containing $x_{2}$, held together by $x_{3}$.
bakni	$x_{1}$ is a cow/cattle/kine/ox/[bull/steer/calf] [beef-producer/bovine] of species/breed $x_{2}$.
bakri	$x_{1}$ is a quantity of/contains/is made of chalk from source $x_{2}$ in form $x_{3}$.
baktu	$x_{1}$ is a bucket/pail/can/deep, solid, wide-topped container of contents $x_{2}$, made of material $x_{3}$.
balji	$x_{1}$ is a bulb [body-part] of plant/species $x_{2}$; [metaphor: rounded, bulgy].
balni	$x_{1}$ is a balcony/overhang/ledge/shelf of building/structure $x_{2}$.
balre	$x_{1}$ is a blade of tool/weapon $x_{2}$.
balvi	$x_{1}$ is in the future of/later than/after $x_{2}$ in time sequence; $x_{1}$ is latter; $x_{2}$ is former.
bancu	$x_{1}$ exceeds/is beyond limit/boundary $x_{2}$ from $x_{3}$ in property/amount $x_{4}$ (ka/ni).
bandu	$x_{1}$ (event) defends/protects $x_{2}$ (object/state) from threat/peril/potential $x_{3}$ (event).
banfi	$x_{1}$ is an amphibian of species/breed $x_{2}$.
bangu	$x_{1}$ is a/the language/dialect used by $x_{2}$ to express/communicate $x_{3}$ (si'o/du'u, not quote).
banli	$x_{1}$ is great/grand in property $x_{2}$ (ka) by standard $x_{3}$.
banro	$x_{1}$ grows/expands [an increasing development] to size/into form $x_{2}$ from $x_{3}$.
banxa	$x_{1}$ is a bank owned by/in banking system $x_{2}$ for banking function(s) $x_{3}$ (event).
banzu	$x_{1}$ (object) suffices/is enough/sufficient for purpose $x_{2}$ under conditions $x_{3}$.
bapli	$x_{1}$ [force] (ka) forces/compels event $x_{2}$ to occur; $x_{1}$ determines property $x_{2}$ to manifest.
barda	$x_{1}$ is big/large in property/dimension(s) $x_{2}$ (ka) as compared with standard/norm $x_{3}$.
bargu	$x_{1}$ arches/curves over/around $x_{2}$ and is made of $x_{3}$; $x_{1}$ is an arch over/around $x_{2}$ of material $x_{3}$.
barja	$x_{1}$ is a tavern/bar/pub serving $x_{2}$ to audience/patrons $x_{3}$.
barna	$x_{1}$(s) is a/are mark(s)/spot(s) on $x_{2}$ of material $x_{3}$.
bartu	$x_{1}$ is on the outside of $x_{2}$; $x_{1}$ is exterior to $x_{2}$.
basna	$x_{1}$ emphasizes/accentuates/gives emphasis/stress/accent to $x_{2}$ by (action) $x_{3}$.
basti	$x_{1}$ replaces/substitutes for/instead of $x_{2}$ in circumstance $x_{3}$; $x_{1}$ is a replacement/substitute.
batci	$x_{1}$ bites/pinches $x_{2}$ on/at specific locus $x_{3}$ with $x_{4}$.
batke	$x_{1}$ is a button/knob/[handle] on/for item $x_{2}$, with purpose $x_{3}$, made of material $x_{4}$.
bavmi	$x_{1}$ is a quantity of barley [grain] of species/strain $x_{2}$.
baxso	$x_{1}$ reflects Malay-Indonesian common language/culture in aspect $x_{2}$.
bebna	$x_{1}$ is foolish/silly in event/action/property [folly] (ka) $x_{2}$; $x_{1}$ is a fool.
bemro	$x_{1}$ reflects North American culture/nationality/geography in aspect $x_{2}$.
bende	$x_{1}$ is a crew/team/gang/squad/band of persons $x_{2}$ directed/led by $x_{3}$ organized for purpose $x_{4}$.
bengo	$x_{1}$ reflects Bengali/Bangladesh culture/nationality/language in aspect $x_{2}$.
benji	$x_{1}$ transfers/sends/transmits $x_{2}$ to receiver $x_{3}$ from transmitter/origin $x_{4}$ via means/medium $x_{5}$.
bersa	$x_{1}$ is a son of mother/father/parents $x_{2}$ [not necessarily biological].
berti	$x_{1}$ is to the north/northern side [right-hand-rule pole] of $x_{2}$ according to frame of reference $x_{3}$.
besna	$x_{1}$ is a/the brain [body-part] of $x_{2}$; [metaphor: intelligence, mental control].
betfu	$x_{1}$ is a/the abdomen/belly/lower trunk [body-part] of $x_{2}$; [metaphor: midsection].
betri	$x_{1}$ is a tragedy/disaster/tragic for $x_{2}$.
bevri	$x_{1}$ carries/hauls/bears/transports cargo $x_{2}$ to $x_{3}$ from $x_{4}$ over path $x_{5}$; $x_{1}$ is a carrier/[porter].
bidju	$x_{1}$ is a bead/pebble [shape/form] of material $x_{2}$.
bifce	$x_{1}$ is a bee/wasp/hornet of species/breed $x_{2}$.
bikla	$x_{1}$ whips/lashes/snaps [a sudden violent motion].
bilga	$x_{1}$ is bound/obliged to/has the duty to do/be $x_{2}$ in/by standard/agreement $x_{3}$; $x_{1}$ must do $x_{2}$.
bilma	$x_{1}$ is ill/sick/diseased with symptoms $x_{2}$ from disease $x_{3}$.
bilni	$x_{1}$ is military/regimented/is strongly organized/prepared by system $x_{2}$ for purpose $x_{3}$.
bindo	$x_{1}$ reflects Indonesian culture/nationality/language in aspect $x_{2}$.
binra	$x_{1}$ insures/indemnifies $x_{2}$ (person) against peril $x_{3}$ (event) providing benefit(s) $x_{4}$ (event).
binxo	$x_{1}$ becomes/changes/converts/transforms into $x_{2}$ under conditions $x_{3}$.
birje	$x_{1}$ is made of/contains/is an amount of beer/ale/brew brewed from $x_{2}$.
birka	$x_{1}$ is a/the arm [body-part] of $x_{2}$; [metaphor: branch with strength].
birti	$x_{1}$ is certain/sure/positive/convinced that $x_{2}$ is true.
bisli	$x_{1}$ is a quantity of/is made of/contains ice [frozen crystal] of composition/material $x_{2}$.
bitmu	$x_{1}$ is a wall/fence separating $x_{2}$ and $x_{3}$ (unordered) of/in structure $x_{4}$.
blabi	$x_{1}$ is white/very-light colored [color adjective].
blaci	$x_{1}$ is a quantity of/is made of/contains glass of composition including $x_{2}$.
blanu	$x_{1}$ is blue [color adjective].
bliku	$x_{1}$ is a block [3-dimensional shape/form] of material $x_{2}$, surfaces/sides $x_{3}$.
bloti	$x_{1}$ is a boat/ship/vessel [vehicle] for carrying $x_{2}$, propelled by $x_{3}$.
bolci	$x_{1}$ is a ball/sphere/orb/globe [shape/form] of material $x_{2}$; $x_{1}$ is a spherical object [made of $x_{2}$].
bongu	$x_{1}$ is a/the bone/ivory [body-part], performing function $x_{2}$ in body of $x_{3}$; [metaphor: calcium].
botpi	$x_{1}$ is a bottle/jar/urn/flask/closable container for $x_{2}$, made of material $x_{3}$ with lid $x_{4}$.
boxfo	$x_{1}$ is a sheet/foil/blanket [2-dimensional shape/form flexible in 3 dimensions] of material $x_{2}$.
boxna	$x_{1}$ is a wave [periodic pattern] in medium $x_{2}$, wave-form $x_{3}$, wave-length $x_{4}$, frequency $x_{5}$.
bradi	$x_{1}$ is an enemy/opponent/adversary/foe of $x_{2}$ in struggle $x_{3}$.
bratu	$x_{1}$ is hail/sleet/freezing rain/solid precipitation of material/composition including $x_{2}$.
brazo	$x_{1}$ reflects Brazilian culture/nationality/language in aspect $x_{2}$.
bredi	$x_{1}$ is ready/prepared for $x_{2}$ (event).
bridi	$x_{1}$ (du'u) is a predicate relationship with relation $x_{2}$ among arguments (sequence/set) $x_{3}$.
brife	$x_{1}$ is a breeze/wind/gale from direction $x_{2}$ with speed $x_{3}$; $x_{1}$ blows from $x_{2}$.
briju	$x_{1}$ is an office/bureau/work-place of worker $x_{2}$ at location $x_{3}$.
brito	$x_{1}$ reflects British/United Kingdom culture/nationality in aspect $x_{2}$.
broda	1st assignable variable predicate (context determines place structure).
brode	2nd assignable variable predicate (context determines place structure).
brodi	3rd assignable variable predicate (context determines place structure).
brodo	4th assignable variable predicate (context determines place structure).
brodu	5th assignable variable predicate (context determines place structure).
bruna	$x_{1}$ is brother of/fraternal to $x_{2}$ by bond/tie/standard/parent(s) $x_{3}$; [not necess. biological].
budjo	$x_{1}$ pertains to the Buddhist culture/religion/ethos in aspect $x_{2}$.
bukpu	$x_{1}$ is an amount of cloth/fabric of type/material $x_{2}$.
bumru	$x_{1}$ is foggy/misty/covered by a fog/mist/vapor of liquid $x_{2}$.
bunda	$x_{1}$ is $x_{2}$ (def. 1) local weight unit(s) [non-metric], standard $x_{3}$, subunits [e.g. ounces] $x_{4}$.
bunre	$x_{1}$ is brown/tan [color adjective].
burcu	$x_{1}$ is a brush for purpose $x_{2}$ (event) with bristles $x_{3}$.
burna	$x_{1}$ is embarrassed/disconcerted/flustered/ill-at-ease about/under conditions $x_{2}$ (abstraction).
cabna	$x_{1}$ is current at/in the present of/during/concurrent/simultaneous with $x_{2}$ in time.
cabra	$x_{1}$ is apparatus/mechanism/device/equipment for function $x_{2}$ controlled/[triggered] by $x_{3}$ (agent).
cacra	$x_{1}$ is $x_{2}$ hours in duration (default is 1 hour) by standard $x_{3}$.
cadzu	$x_{1}$ walks/strides/paces on surface $x_{2}$ using limbs $x_{3}$.
cafne	$x_{1}$ (event) often/frequently/commonly/customarily occurs/recurs by standard $x_{2}$.
cakla	$x_{1}$ is made of/contains/is a quantity of chocolate/cocoa.
calku	$x_{1}$ is a shell/husk [hard, protective covering] around $x_{2}$ composed of $x_{3}$.
canci	$x_{1}$ vanishes/disappears from location $x_{2}$; $x_{1}$ ceases to be observed at $x_{2}$ using senses/sensor $x_{3}$.
cando	$x_{1}$ is idle/at rest/inactive.
cange	$x_{1}$ is a farm/ranch at $x_{2}$, farmed by $x_{3}$, raising/producing $x_{4}$; (adjective:) $x_{1}$ is agrarian.
canja	$x_{1}$ exchanges/trades/barters commodity $x_{2}$ for $x_{3}$ with $x_{4}$; $x_{1}$, $x_{4}$ is a trader/merchant/businessman.
canko	$x_{1}$ is a window/portal/opening [portal] in wall/building/structure $x_{2}$.
canlu	$x_{1}$ is space/volume/region/room [at-least-3-dimensional area] occupied by $x_{2}$.
canpa	$x_{1}$ is a shovel/spade [bladed digging implement] for digging $x_{2}$.
canre	$x_{1}$ is a quantity of/contains/is made of sand/grit from source $x_{2}$ of composition including $x_{3}$.
canti	$x_{1}$ is a/the gut(s)/entrails/intestines/viscera/innards/digestive system [body-part] of $x_{2}$.
carce	$x_{1}$ is a cart/carriage/wagon [wheeled vehicle] for carrying $x_{2}$, propelled by $x_{3}$.
carmi	$x_{1}$ is intense/bright/saturated/brilliant in property (ka) $x_{2}$ as received/measured by observer $x_{3}$.
carna	$x_1$ turns about vector $x_2$ towards direction $x_3$, turning angular distance / to face point $x_4$
cartu	$x_{1}$ is a chart/diagram/map of/about $x_{2}$ showing formation/data-points $x_{3}$.
carvi	$x_{1}$ rains/showers/[precipitates] to $x_{2}$ from $x_{3}$; $x_{1}$ is precipitation [not limited to 'rain'].
casnu	$x_{1}$(s) (mass normally, but 1 individual/jo'u possible) discuss(es)/talk(s) about topic/subject $x_{2}$.
catke	$x_{1}$ [agent] shoves/pushes $x_{2}$ at locus $x_{3}$.
catlu	$x_{1}$ looks at/examines/views/inspects/regards/watches/gazes at $x_{2}$.
catni	$x_{1}$ has authority/is an official in/on/over matter/sphere/persons $x_{2}$ derived on basis $x_{3}$.
catra	$x_{1}$ (agent) kills/slaughters/murders $x_{2}$ by action/method $x_{3}$.
caxno	$x_{1}$ is shallow in extent in direction/property $x_{2}$ away from reference point $x_{3}$ by standard $x_{4}$.
cecla	$x_{1}$ launches/fires/shoots projectile/missile $x_{2}$, propelled by $x_{3}$ [propellant/propulsion].
cecmu	$x_{1}$ is a community/colony of organisms $x_{2}$.
cedra	$x_{1}$ is an era/epoch/age characterized by $x_{2}$ (event/property/interval/idea).
cenba	$x_{1}$ varies/changes in property/quantity $x_{2}$ (ka/ni) in amount/degree $x_{3}$ under conditions $x_{4}$.
censa	$x_{1}$ is holy/sacred to person/people/culture/religion/cult/group $x_{2}$.
centi	$x_{1}$ is a hundredth [1/100; $10^{-2}$] of $x_{2}$ in dimension/aspect $x_{3}$ (default is units).
cerda	$x_{1}$ is an heir to/is to inherit $x_{2}$ (object/quality) from $x_{3}$ according to rule $x_{4}$.
cerni	$x_{1}$ is a morning [dawn until after typical start-of-work for locale] of day $x_{2}$ at location $x_{3}$.
certu	$x_{1}$ is an expert/pro/has prowess in/is skilled at $x_{2}$ (event/activity) by standard $x_{3}$.
cevni	$x_{1}$ is a/the god/deity of people(s)/religion $x_{2}$ with dominion over $x_{3}$ [sphere]; $x_{1}$ is divine.
cfari	$x_{1}$ [state/event/process] commences/initiates/starts/begins to occur; (intransitive verb).
cfika	$x_{1}$ is a work of fiction about plot/theme/subject $x_{2}$/under convention $x_{2}$ by author $x_{3}$.
cfila	$x_{1}$ (property - ka) is a flaw/fault/defect in $x_{2}$ causing $x_{3}$.
cfine	$x_{1}$ is a wedge [shape/form/tool] of material $x_{2}$.
cfipu	$x_{1}$ (event/state) confuses/baffles $x_{2}$ [observer] due to [confusing] property $x_{3}$ (ka).
ciblu	$x_{1}$ is blood/vital fluid of organism $x_{2}$.
cicna	$x_{1}$ is cyan/turquoise/greenish-blue [color adjective].
cidja	$x_{1}$ is food/feed/nutriment for $x_{2}$; $x_{1}$ is edible/gives nutrition to $x_{2}$.
cidni	$x_{1}$ is a/the knee/elbow/knuckle [hinged joint, body-part] of limb $x_{2}$ of body $x_{3}$.
cidro	$x_{1}$ is a quantity of/contains/is made of hydrogen (H); [metaphor: light, flammable].
cifnu	$x_{1}$ is an infant/baby [helpless through youth/incomplete development] of species $x_{2}$.
cigla	$x_{1}$ is a/the gland [body-part] secreting $x_{2}$, of body $x_{3}$; $x_{2}$ is a secretion of $x_{1}$.
cikna	(adjective:) $x_{1}$ is awake/alert/conscious.
cikre	$x_{1}$ repairs/mends/fixes $x_{2}$ for use $x_{3}$.
ciksi	$x_{1}$ (person) explains $x_{2}$ (event/state/property) to $x_{3}$ with explanation $x_{4}$ (du'u).
cilce	(adjective:) $x_{1}$ is wild/untamed.
cilmo	$x_{1}$ is moist/wet/damp with liquid $x_{2}$.
cilre	$x_{1}$ learns $x_{2}$ (du'u) about subject $x_{3}$ from source $x_{4}$ (obj./event) by method $x_{5}$ (event/process).
cilta	$x_{1}$ is a thread/filament/wire [shape/form] of material $x_{2}$.
cimde	$x_{1}$ (property - ka) is a dimension of space/object $x_{2}$ according to rules/model $x_{3}$.
cimni	$x_{1}$ is infinite/unending/eternal in property/dimension $x_{2}$, to degree $x_{3}$ (quantity)/of type $x_{3}$.
cinba	$x_{1}$ (agent) kisses/busses $x_{2}$ at locus $x_{3}$.
cindu	$x_{1}$ is an oak, a type of tree of species/strain $x_{2}$.
cinfo	$x_{1}$ is a lion/[lioness] of species/breed $x_{2}$.
cinje	$x_{1}$ is a wrinkle/crease/fold [shape/form] in $x_{2}$.
cinki	$x_{1}$ is an insect/arthropod of species $x_{2}$; [bug/beetle].
cinla	$x_{1}$ is thin in direction/dimension $x_{2}$ by standard $x_{3}$; [relatively short in smallest dimension].
cinmo	$x_{1}$ feels emotion $x_{2}$ (ka) about $x_{3}$.
cinri	$x_{1}$ (abstraction) interests/is interesting to $x_{2}$; $x_{2}$ is interested in $x_{1}$.
cinse	$x_{1}$ in activity/state $x_{2}$ exhibits sexuality/gender/sexual orientation $x_{3}$ (ka) by standard $x_{4}$.
cinta	$x_{1}$ [material] is a paint of pigment/active substance $x_{2}$, in a base of $x_{3}$.
cinza	$x_{1}$ is a/are tong(s)/chopsticks/pincers/tweezers/pliers [tool/body-part] for $x_{2}$ to pinch $x_{3}$.
cipni	$x_{1}$ is a bird/avian/fowl of species $x_{2}$.
cipra	$x_{1}$ (process/event) is a test for/proof of property/state $x_{2}$ in subject $x_{3}$ (individ./set/mass).
cirko	$x_{1}$ loses person/thing $x_{2}$ at/near $x_{3}$; $x_{1}$ loses property/feature $x_{2}$ in conditions/situation $x_{3}$.
cirla	$x_{1}$ is a quantity of/contains cheese/curd from source $x_{2}$.
ciska	$x_{1}$ inscribes/writes $x_{2}$ on display/storage medium $x_{3}$ with writing implement $x_{4}$; $x_{1}$ is a scribe.
cisma	$x_{1}$ smiles/grins (facial expression).
ciste	$x_{1}$ (mass) is a system interrelated by structure $x_{2}$ among components $x_{3}$ (set) displaying $x_{4}$ (ka).
citka	$x_{1}$ eats/ingests/consumes (transitive verb) $x_{2}$.
citno	$x_{1}$ is young/youthful [relatively short in elapsed duration] by standard $x_{2}$.
citri	$x_{1}$ is a history of $x_{2}$ according to $x_{3}$ (person)/from point-of-view $x_{3}$.
citsi	$x_{1}$ is a season/is seasonal [cyclical interval], defined by interval/property $x_{2}$, of year(s) $x_{3}$.
civla	$x_{1}$ is a louse/flea [blood-sucking arthropod] of species/breed $x_{2}$, parasitic on $x_{3}$.
cizra	$x_{1}$ is strange/weird/deviant/bizarre/odd to $x_{2}$ in property $x_{3}$ (ka).
ckabu	$x_{1}$ is a quantity of/contains/is made of rubber/latex from source $x_{2}$ of composition including $x_{3}$.
ckafi	$x_{1}$ is made of/contains/is a quantity of coffee from source/bean/grain $x_{2}$.
ckaji	$x_{1}$ has/is characterized by property/feature/trait/aspect/dimension $x_{2}$ (ka); $x_{2}$ is manifest in $x_{1}$.
ckana	$x_{1}$ is a bed/pallet of material $x_{2}$ for holding/supporting $x_{3}$ (person/object/event).
ckape	$x_{1}$ is perilous/dangerous/potentially harmful to $x_{2}$ under conditions $x_{3}$.
ckasu	$x_{1}$ ridicules/mocks/scoffs at $x_{2}$ about $x_{3}$ (property/event) by doing activity $x_{4}$ (event).
ckeji	$x_{1}$ feels ashamed/mortified/humiliated under conditions $x_{2}$ before community/audience $x_{3}$.
ckiku	$x_{1}$ is a key fitting/releasing/opening/unlocking lock $x_{2}$, and having relevant properties $x_{3}$.
ckilu	$x_{1}$ (si'o) is a scale of units for measuring/observing/determining $x_{2}$ (state).
ckini	$x_{1}$ is related to/associated with/akin to $x_{2}$ by relationship $x_{3}$.
ckire	$x_{1}$ is grateful/thankful to/appreciative of $x_{2}$ for $x_{3}$ (event/property).
ckule	$x_{1}$ is school/institute/academy at $x_{2}$ teaching subject(s) $x_{3}$ to audien./commun. $x_{4}$ operated by $x_{5}$.
ckunu	$x_{1}$ is a conifer/pine/fir of species/strain $x_{2}$ with cones $x_{3}$.
cladu	$x_{1}$ is loud/noisy at observation point $x_{2}$ by standard $x_{3}$.
clani	$x_{1}$ is long in dimension/direction $x_{2}$ (default longest dimension) by measurement standard $x_{3}$.
claxu	$x_{1}$ is without/lacking/free of/lacks $x_{2}$; $x_{1}$ is $x_{2}$-less.
clika	$x_{1}$ is a moss/lichen of species/strain $x_{2}$ growing on $x_{3}$; (adjective:) $x_{1}$ is mossy.
clira	$x_{1}$ (event) is early by standard $x_{2}$.
clite	$x_{1}$ is polite/courteous/civil in matter $x_{2}$ according to standard/custom $x_{3}$.
cliva	$x_{1}$ leaves/goes away/departs/parts/separates from $x_{2}$ via route $x_{3}$.
clupa	$x_{1}$ is a loop/circuit of $x_{2}$ [material].
cmaci	$x_{1}$ is a mathematics of type/describing $x_{2}$.
cmalu	$x_{1}$ is small in property/dimension(s) $x_{2}$ (ka) as compared with standard/norm $x_{3}$.
cmana	$x_{1}$ is a mountain/hill/mound/[rise]/[peak]/[summit]/[highlands] projecting from land mass $x_{2}$.
cmavo	$x_{1}$ is a structure word of grammatical class $x_{2}$, with meaning/function $x_{3}$ in usage (language) $x_{4}$.
cmene	$x_{1}$ (quoted word(s)) is a/the name/title/tag of $x_{2}$ to/used-by namer/name-user $x_{3}$ (person).
cmila	$x_{1}$ laughs (emotional expression).
cmima	$x_{1}$ is a member/element of set $x_{2}$; $x_{1}$ belongs to group $x_{2}$; $x_{1}$ is amid/among/amongst group $x_{2}$.
cmoni	$x_{1}$ utters moan/groan/howl/scream [non-linguistic utterance] $x_{2}$ expressing $x_{3}$ (property).
cnano	$x_{1}$ [value] is a norm/average in property/amount $x_{2}$ (ka/ni) among $x_{3}$(s) (set) by standard $x_{4}$.
cnebo	$x_{1}$ is a/the neck [body-part] of $x_{2}$; [metaphor: a relatively narrow point].
cnemu	$x_{1}$ (agent) rewards $x_{2}$ [recipient] for atypical $x_{3}$ (event/property) with reward/desserts $x_{4}$.
cnici	$x_{1}$ is orderly/neat/ordered in property/quantity $x_{2}$ (ka/ni).
cnino	$x_{1}$ is new/unfamiliar/novel to observer $x_{2}$ in feature $x_{3}$ (ka) by standard $x_{4}$; $x_{1}$ is a novelty.
cnisa	$x_{1}$ is a quantity of/contains/is made of lead (Pb); [metaphor: heavy, malleable, soft metal].
cnita	$x_{1}$ is directly/vertically beneath/below/under/underneath/down from $x_{2}$ in frame of reference $x_{3}$.
cokcu	$x_{1}$ soaks up/absorbs/sucks up $x_{2}$ from $x_{3}$ into $x_{4}$; $x_{1}$ is an absorbant.
condi	$x_{1}$ is deep in extent in direction/property $x_{2}$ away from reference point $x_{3}$ by standard $x_{4}$.
cortu	$x_{1}$ hurts/feels pain/hurt at locus $x_{2}$.
cpacu	$x_{1}$ gets/procures/acquires/obtains/accepts $x_{2}$ from source $x_{3}$ [previous possessor not implied].
cpana	$x_{1}$ is upon/atop/resting on/lying on [the upper surface of] $x_{2}$ in frame of reference/gravity $x_{3}$.
cpare	$x_{1}$ climbs/clambers/creeps/crawls on surface $x_{2}$ in direction $x_{3}$ using $x_{4}$ [limbs/tools].
cpedu	$x_{1}$ requests/asks/petitions/solicits for $x_{2}$ of/from $x_{3}$ in manner/form $x_{4}$.
cpina	$x_{1}$ is pungent/piquant/peppery/spicy/irritating to sense $x_{2}$.
cradi	$x_{1}$ broadcasts/transmits [using radio waves] $x_{2}$ via station/frequency $x_{3}$ to [radio] receiver $x_{4}$.
crane	$x_{1}$ is anterior/ahead/forward/(in/on) the front of $x_{2}$ which faces/in-frame-of-reference $x_{3}$.
creka	$x_{1}$ is a shirt/blouse/top [upper-body garment - not necessarily sleeved or buttoned], material $x_{2}$.
crepu	$x_{1}$ (agent) harvests/reaps/gathers crop/product/objects $x_{2}$ from source/area $x_{3}$.
cribe	$x_{1}$ is a bear/ursoid of species/breed $x_{2}$.
crida	$x_{1}$ is a fairy/elf/gnome/brownie/pixie/goblin/kobold [mythical humanoid] of mythos/religion $x_{2}$.
crino	$x_{1}$ is green/verdant [color adjective].
cripu	$x_{1}$ is a bridge/span over/across $x_{2}$ between $x_{3}$ and $x_{4}$ [unordered, typically destination first].
crisa	$x_{1}$ is summer/summertime [hot season] of year $x_{2}$ at location $x_{3}$.
critu	$x_{1}$ is autumn/fall [harvest/cooling season] of year $x_{2}$ at location $x_{3}$.
ctaru	$x_{1}$ is a tide [cyclical/periodic expansion] in $x_{2}$ caused by $x_{3}$.
ctebi	$x_{1}$ is a/the lip [body-part]/rim of orifice $x_{2}$ of body $x_{3}$; (adjective:) $x_{1}$ is labial.
cteki	$x_{1}$ is a tax/levy/duty on goods/services/event $x_{2}$ levied against $x_{3}$ by authority/collector $x_{4}$.
ctile	$x_{1}$ is a quantity of petroleum/oil from source $x_{2}$.
ctino	$x_{1}$ is a shadow/the shade of object $x_{2}$, made by light/energy source $x_{3}$.
ctuca	$x_{1}$ teaches audience $x_{2}$ ideas/methods/lore $x_{3}$ (du'u) about subject(s) $x_{4}$ by method $x_{5}$ (event).
cukla	$x_{1}$ is round/circular [2-dimensional shape/form]; $x_{1}$ is a disk/circle/ring.
cukta	$x_{1}$ is a book containing work $x_{2}$ by author $x_{3}$ for audience $x_{4}$ preserved in medium $x_{5}$.
culno	$x_{1}$ is full/completely filled with $x_{2}$.
cumki	$x_{1}$ (event/state/property) is possible under conditions $x_{2}$; $x_{1}$ may/might occur; $x_{1}$ is a maybe.
cumla	$x_{1}$ is humble/modest about $x_{2}$ (abstraction); $x_{1}$ displays humility about $x_{2}$.
cunmi	$x_{1}$ is a quantity of millet [grain] of species/strain $x_{2}$.
cunso	$x_{1}$ is random/fortuitous/unpredictable under conditions $x_{2}$, with probability distribution $x_{3}$.
cuntu	$x_{1}$ is an affair/organized activity involving person(s) $x_{2}$ (ind./mass); $x_{1}$ is $x_{2}$'s business.
cupra	$x_{1}$ produces $x_{2}$ [product] by process $x_{3}$.
curmi	$x_{1}$ (agent) lets/permits/allows $x_{2}$ (event) under conditions $x_{3}$; $x_{1}$ grants privilege $x_{2}$.
curnu	$x_{1}$ is a worm/invertebrate animal of species/breed $x_{2}$.
curve	$x_{1}$ is pure/unadulterated/unmitigated/simple in property $x_{2}$ (ka).
cusku	$x_{1}$ (agent) expresses/says $x_{2}$ (sedu'u/text/lu'e concept) for audience $x_{3}$ via expressive medium $x_{4}$.
cutci	$x_{1}$ is a shoe/boot/sandal for covering/protecting [feet/hooves] $x_{2}$, and of material $x_{3}$.
cutne	$x_{1}$ is a/the chest/thorax/upper trunk/[rib cage/breast] [body-part] of $x_{2}$.
cuxna	$x_{1}$ chooses/selects $x_{2}$ [choice] from set/sequence of alternatives $x_{3}$ (complete set).
dacru	$x_{1}$ is a drawer/file in structure $x_{2}$, a [sliding compartment] container for contents $x_{3}$.
dacti	$x_{1}$ is a material object enduring in space-time; $x_{1}$ is a thing.
dadjo	$x_{1}$ pertains to the Taoist culture/ethos/religion in aspect $x_{2}$.
dakfu	$x_{1}$ is a knife (tool) for cutting $x_{2}$, with blade of material $x_{3}$.
dakli	$x_{1}$ is a sack/bag with contents $x_{2}$, and of material $x_{3}$.
damba	$x_{1}$ fights/combats/struggles with $x_{2}$ over issue $x_{3}$ (abstract); $x_{1}$ is a fighter/combatant.
damri	$x_{1}$ is a drum/cymbal/gong [percussion musical instrument] with beater/actuator $x_{2}$.
dandu	$x_{1}$ hangs/dangles/is suspended from $x_{2}$ by/at/with joint $x_{3}$.
danfu	$x_{1}$ is the answer/response/solution/[reply] to question/problem $x_{2}$.
danlu	$x_{1}$ is an animal/creature of species $x_{2}$; $x_{1}$ is biologically animate.
danmo	$x_{1}$ is made of/contains/is a quantity of smoke/smog/air pollution from source $x_{2}$.
danre	$x_{1}$ (force) puts pressure on/presses/applies force to $x_{2}$.
dansu	$x_{1}$ (individual, mass) dances to accompaniment/music/rhythm $x_{2}$.
danti	$x_{1}$ is a ballistic projectile [e.g. bullet/missile] for firing by [gun/propelling launcher] $x_{2}$.
daplu	$x_{1}$ is an island/atoll/key of [material/properties] $x_{2}$ in surroundings/body $x_{3}$; $x_{1}$ is insular.
dapma	$x_{1}$ curses/damns/condemns $x_{2}$ to fate (event) $x_{3}$.
dargu	$x_{1}$ is a road/highway to $x_{2}$ from $x_{3}$ with route $x_{4}$ ($x_{2}$/$x_{3}$ may be unordered).
darlu	$x_{1}$ argues for stand $x_{2}$ against stand $x_{3}$; [an opponent is not necessary].
darno	$x_{1}$ is far/distant from $x_{2}$ in property $x_{3}$ (ka).
darsi	$x_{1}$ shows audacity/chutzpah in behavior $x_{2}$ (event/activity); $x_{1}$ dares to do/be $x_{2}$ (event/ka).
darxi	$x_{1}$ hits/strikes/[beats] $x_{2}$ with instrument [or body-part] $x_{3}$ at locus $x_{4}$.
daski	$x_{1}$ is a pocket/pouch of/in garment/item $x_{2}$.
dasni	$x_{1}$ wears/is robed/garbed in $x_{2}$ as a garment of type $x_{3}$.
daspo	$x_{1}$ (event) destroys/ruins/wrecks/despoils $x_{2}$; $x_{1}$ is destructive.
dasri	$x_{1}$ is a ribbon/tape/strip/band/stripe of material $x_{2}$.
datka	$x_{1}$ is a duck/[drake] of species/breed $x_{2}$.
datni	$x_{1}$ (du'u) [fact/measurement] is data/information/statistic(s) about $x_{2}$ gathered by method $x_{3}$.
decti	$x_{1}$ is a tenth [1/10; $10^{-1}$] of $x_{2}$ in dimension/aspect $x_{3}$ (default is units).
degji	$x_{1}$ is a/the finger/digit/toe [body-part] on limb/body site $x_{2}$ of body $x_{3}$; [metaphor: peninsula].
dejni	$x_{1}$ owes $x_{2}$ in debt/obligation to creditor $x_{3}$ in return for $x_{4}$ [service, loan]; $x_{1}$ is a debtor.
dekpu	$x_{1}$ is $x_{2}$ (default 1) local volume unit(s) [non-metric; e.g. bushel], standard $x_{3}$, $x_{4}$ subunits.
dekto	$x_{1}$ is ten [10; $10^1$ ] of $x_{2}$ in dimension/aspect $x_{3}$ (default is units).
delno	$x_{1}$ is $x_{2}$ candela [metric unit] in luminosity (default is 1) by standard $x_{3}$.
dembi	$x_{1}$ is a bean/pea/leguminous seed from plant [legume] $x_{2}$.
denci	$x_{1}$ is a/the tooth [body-part] of $x_{2}$; (adjective:) $x_{1}$ is dental.
denmi	$x_{1}$ is dense/concentrated/packed/intense in property $x_{2}$ (ka) at location/locus $x_{3}$.
denpa	$x_{1}$ awaits/waits/pauses for/until $x_{2}$ at state $x_{3}$ before starting/continuing $x_{4}$ (activity/process).
dertu	$x_{1}$ is a quantity of/contains/is made of dirt/soil/earth/ground from source $x_{2}$ of composition $x_{3}$.
derxi	$x_{1}$ is a heap/pile/stack/mound/hill of materials $x_{2}$ at location $x_{3}$.
desku	$x_{1}$ shakes/quakes/trembles/quivers/shudders/wobbles/vibrates from force $x_{2}$.
detri	$x_{1}$ is the date [day,{week},{month},year] of event/state $x_{2}$, at location $x_{3}$, by calendar $x_{4}$.
dicra	$x_{1}$ (event) interrupts/stops/halts/[disrupts] $x_{2}$ (object/event/process) due to quality $x_{3}$.
dikca	$x_{1}$ is electricity [electric charge or current] in/on $x_{2}$ of polarity/quantity $x_{3}$ (def. negative).
diklo	$x_{1}$ is local to $x_{2}$; $x_{1}$ is confined to locus $x_{2}$ within range $x_{3}$; $x_{1}$ is regional
dikni	$x_{1}$ is regular/cyclical/periodic in property (ka)/activity $x_{2}$ with period/interval $x_{3}$.
dilcu	$x_{1}$ is a quotient of '$x_{2}$/$x_{3}$' [dividend $x_{2}$ divided by divisor $x_{3}$], leaving remainder $x_{4}$.
dilnu	$x_{1}$ is a cloud/mass of clouds of material $x_{2}$ in air mass $x_{3}$ at floor/base elevation $x_{4}$.
dimna	$x_{1}$ is a fate/destiny of $x_{2}$; [doom, curse are mabla-forms]; $x_{2}$ is fated/predestined/doomed to $x_{1}$.
dinju	$x_{1}$ is a building/edifice for purpose $x_{2}$.
dinko	$x_{1}$ is a nail/tack [pointed driven/frictional fastener] of type/size $x_{2}$ (ka), made of material $x_{3}$.
dirba	$x_{1}$ is dear/precious/darling to $x_{2}$; $x_{1}$ is emotionally valued by $x_{2}$.
dirce	$x_{1}$ radiates/emits $x_{2}$ under conditions $x_{3}$.
dirgo	$x_{1}$ is a drop [small, cohesive shape] of material [liquid/vapor] $x_{2}$ in surrounding material $x_{3}$.
dizlo	$x_{1}$ is low/down/downward in frame of reference $x_{2}$ as compared with baseline/standard height $x_{3}$.
djacu	$x_{1}$ is made of/contains/is a quantity/expanse of water; (adjective:) $x_{1}$ is aqueous/[aquatic].
djedi	$x_{1}$ is $x_{2}$ full days in duration (default is 1 day) by standard $x_{3}$; (adjective:) $x_{1}$ is diurnal.
djica	$x_{1}$ desires/wants/wishes $x_{2}$ (event/state) for purpose $x_{3}$.
djine	$x_{1}$ is a ring/annulus/torus/circle [shape/form] of material $x_{2}$, inside diam. $x_{3}$, outside diam. $x_{4}$.
djuno	$x_{1}$ knows fact(s) $x_{2}$ (du'u) about subject $x_{3}$ by epistemology $x_{4}$.
donri	$x_{1}$ is the daytime of day $x_{2}$ at location $x_{3}$; (adjective:) $x_{1}$ is diurnal (vs. nocturnal).
dotco	$x_{1}$ reflects German/Germanic culture/nationality/language in aspect $x_{2}$.
draci	$x_{1}$ is a drama/play about $x_{2}$ [plot/theme/subject] by dramatist $x_{3}$ for audience $x_{4}$ with actors $x_{5}$.
drani	$x_{1}$ is correct/proper/right/perfect in property/aspect $x_{2}$ (ka) in situation $x_{3}$ by standard $x_{4}$.
drata	$x_{1}$ isn't the-same-thing-as/is different-from/other-than $x_{2}$ by standard $x_{3}$; $x_{1}$ is something else.
drudi	$x_{1}$ is a roof/top/ceiling/lid of $x_{2}$.
dugri	$x_{1}$ is the logarithm of $x_{2}$ with base $x_{3}$.
dukse	$x_{1}$ is an excess of/too much of $x_{2}$ by standard $x_{3}$.
dukti	$x_{1}$ is polar opposite from/contrary to $x_{2}$ in property/on scale $x_{3}$ (property/si'o).
dunda	$x_{1}$ [donor] gives/donates gift/present $x_{2}$ to recipient/beneficiary $x_{3}$ [without payment/exchange].
dunja	$x_{1}$ freezes/jells/solidifies at temperature $x_{2}$ and pressure $x_{3}$.
dunku	$x_{1}$ is anguished/distressed/emotionally wrought/stressed by $x_{2}$.
dunli	$x_{1}$ is equal/congruent to/as much as $x_{2}$ in property/dimension/quantity $x_{3}$.
dunra	$x_{1}$ is winter/wintertime [cold season] of year $x_{2}$ at location $x_{3}$.
dzena	$x_{1}$ is an elder/ancestor of $x_{2}$ by bond/tie/degree $x_{3}$; $x_{1}$'s generation precedes $x_{2}$'s parents.
dzipo	$x_{1}$ reflects Antarctican culture/nationality/geography in aspect $x_{2}$.
facki	$x_{1}$ discovers/finds out $x_{2}$ (du'u) about subject/object $x_{3}$; $x_{1}$ finds (fi) $x_{3}$ (object).
fadni	$x_{1}$ [member] is ordinary/common/typical/usual in property $x_{2}$ (ka) among members of $x_{3}$ (set).
fagri	$x_{1}$ is a fire/flame in fuel $x_{2}$ burning-in/reacting-with oxidizer $x_{3}$ (default air/oxygen).
falnu	$x_{1}$ is a sail for gathering propelling material $x_{2}$ on vehicle/motor $x_{3}$.
famti	$x_{1}$ is an aunt/uncle of $x_{2}$ by bond/tie $x_{3}$; $x_{1}$ is an associated member of $x_{2}$'s parent's generation.
fancu	$x_{1}$ is a function/single-valued mapping from domain $x_{2}$ to range $x_{3}$ defined by expression/rule $x_{4}$.
fange	$x_{1}$ is foreign/alien/[exotic]/unfamiliar to $x_{2}$ in property $x_{3}$ (ka).
fanmo	$x_{1}$ is an end/finish/termination of thing/process $x_{2}$; [not necessarily implying completeness].
fanri	$x_{1}$ is a factory/foundry/industrial plant/mill producing $x_{2}$ from materials $x_{3}$.
fanta	$x_{1}$ prevents/keeps/stops/restrains/constrains event $x_{2}$ from occurring.
fanva	$x_{1}$ translates text/utterance $x_{2}$ to language $x_{3}$ from language $x_{4}$ with translation result $x_{5}$.
fanza	$x_{1}$ (event) annoys/irritates/bothers/distracts $x_{2}$.
fapro	$x_{1}$ opposes/balances/contends against opponent(s) $x_{2}$ (person/force ind./mass) about $x_{3}$ (abstract).
farlu	$x_{1}$ falls/drops to $x_{2}$ from $x_{3}$ in gravity well/frame of reference $x_{4}$.
farna	$x_{1}$ is the direction of $x_{2}$ (object/event) from origin/in frame of reference $x_{3}$.
farvi	$x_{1}$ develops/evolves towards/into $x_{2}$ from $x_{3}$ through stages $x_{4}$.
fasnu	$x_{1}$ (event) is an event that happens/occurs/takes place; $x_{1}$ is an incident/happening/occurrence.
fatci	$x_{1}$ (du'u) is a fact/reality/truth/actuality, in the absolute.
fatne	$x_{1}$ [sequence] is in reverse order from $x_{2}$ [sequence]; $x_{1}$ (object) is inverted from $x_{2}$ (object).
fatri	$x_{1}$ is distributed/allotted/allocated/shared among $x_{2}$ with shares/portions $x_{3}$; ($x_{2}$/$x_{3}$ fa'u).
febvi	$x_{1}$ boils/evaporates at temperature $x_{2}$ and pressure $x_{3}$.
femti	$x_{1}$ is $10^{-15}$ of $x_{2}$ in dimension/aspect $x_{3}$ (default is units).
fendi	$x_{1}$ (agent) divides/partitions/separates $x_{2}$ into sections/parts/ind. $x_{3}$ by method/partition $x_{4}$.
fengu	$x_{1}$ is angry/mad at $x_{2}$ for $x_{3}$ (action/state/property).
fenki	$x_{1}$ (action/event) is crazy/insane/mad/frantic/in a frenzy (one sense) by standard $x_{2}$.
fenra	$x_{1}$ is a crack/fissure/pass/cleft/ravine/chasm/[defect/flaw] [shape/form] in $x_{2}$.
fenso	$x_{1}$ sews/stitches/sutures materials $x_{2}$ (ind./set) together with tool(s) $x_{3}$, using filament $x_{4}$.
fepni	$x_{1}$ is measured in kopeck/cent money-subunits as $x_{2}$ [quantity], in monetary system $x_{3}$.
fepri	$x_{1}$ is a/the lung [body-part] of $x_{2}$; [metaphor: breathing/respiratory apparatus/bellows].
ferti	$x_{1}$ is fertile/conducive for supporting the growth/development of $x_{2}$; $x_{1}$ is fruitful/prolific.
festi	$x_{1}$(s) is/are waste product(s) [left to waste] by $x_{2}$ (event/activity).
fetsi	$x_1$ is a female/doe of species $x_2$ evidencing feminine physical/biological/genetic trait(s) $x_3$ (ka); $x_1$ is feminine.
figre	$x_{1}$ is a fig [fruit/tree] of species/strain $x_{2}$.
filso	$x_{1}$ reflects Palestinian culture/nationality in aspect $x_{2}$.
finpe	$x_{1}$ is a fish of species $x_{2}$ [metaphorical extension to sharks, non-fish aquatic vertebrates].
finti	$x_{1}$ invents/creates/composes/authors $x_{2}$ for function/purpose $x_{3}$ from existing elements/ideas $x_{4}$.
flalu	$x_{1}$ is a law specifying $x_{2}$ (state/event) for community $x_{3}$ under conditions $x_{4}$ by lawgiver(s) $x_{5}$.
flani	$x_{1}$ is a flute/pipe/fife/recorder [flute-like/air-reed musical instrument].
flecu	$x_{1}$ is a current/flow/river of/in $x_{2}$ flowing in direction to/towards $x_{3}$ from direction/source $x_{4}$.
fliba	$x_{1}$ fails at doing $x_{2}$ (state/event); $x_{1}$ is a failure at its role in $x_{2}$.
flira	$x_{1}$ is a/the face [head/body-part] of $x_{2}$; (adjective:) $x_{1}$ is facial.
foldi	$x_{1}$ is a field [shape/form] of material $x_{2}$; $x_{1}$ is a broad uniform expanse of $x_{2}$.
fonmo	$x_{1}$ is a quantity of foam/froth/suds of material $x_{2}$, with bubbles/vacuoles of material $x_{3}$.
fonxa	$x_{1}$ is a telephone transceiver/modem attached to system/network $x_{2}$.
forca	$x_{1}$ is a fork/fork-type tool/utensil for purpose $x_{2}$ with tines/prongs $x_{3}$ on base/support $x_{4}$.
fraso	$x_{1}$ reflects French/Gallic culture/nationality/language in aspect $x_{2}$.
frati	$x_{1}$ reacts/responds/answers with action $x_{2}$ to stimulus $x_{3}$ under conditions $x_{4}$; $x_{1}$ is responsive.
fraxu	$x_{1}$ forgives $x_{2}$ for event/state/activity $x_{3}$.
frica	$x_{1}$ differs/is distinct from/contrasts with/is unlike $x_{2}$ in property/dimension/quantity $x_{3}$.
friko	$x_{1}$ reflects African culture/nationality/geography in aspect $x_{2}$.
frili	$x_{1}$ (action) is easy/simple/facile for $x_{2}$ (agent) under conditions $x_{3}$; $x_{2}$ does $x_{1}$ freely/easily.
frinu	$x_{1}$ is a fraction, with numerator $x_{2}$, denominator $x_{3}$ ($x_{2}$/$x_{3}$).
friti	$x_{1}$ offers/proffers $x_{2}$ [offering] to $x_{3}$ with conditions $x_{4}$.
frumu	$x_{1}$ frowns/grimaces (facial expression).
fukpi	$x_{1}$ is a copy/replica/duplicate/clone of $x_{2}$ in form/medium $x_{3}$ made by method $x_{4}$ (event).
fulta	$x_{1}$ (passive) floats on/in fluid (gas/liquid) $x_{2}$; $x_{1}$ is buoyant.
funca	$x_{1}$ (event/property) is determined by the luck/fortune of $x_{2}$; (note mabla/zabna not implied). $x_{1}$ is determined by chance.
fusra	$x_{1}$ rots/decays/ferments with decay/fermentation agent $x_{2}$; $x_{1}$ is rotten/decayed/fermented.
fuzme	$x_{1}$ is responsible/accountable for $x_{2}$ (action/resulting state) to judge/authority $x_{3}$.
gacri	$x_{1}$ is a cover/[lid/top] for covering/concealing/sheltering $x_{2}$.
gadri	$x_{1}$ is an article/descriptor labelling description $x_{2}$ (text) in language $x_{3}$ with semantics $x_{4}$.
galfi	$x_{1}$ (event) modifies/alters/changes/transforms/converts $x_{2}$ into $x_{3}$.
galtu	$x_{1}$ is high/up/upward in frame of reference $x_{2}$ as compared with baseline/standard height $x_{3}$.
galxe	$x_{1}$ is a/the throat/gullet [body-part] of $x_{2}$; [metaphor: narrow(ing) opening of a deep hole].
ganlo	$x_{1}$ (portal/passage/entrance-way) is closed/shut/not open, preventing passage/access to $x_{2}$ by $x_{3}$ (something being blocked).
ganra	$x_{1}$ is broad/wide in dimension $x_{2}$ [2nd most significant dimension] by standard $x_{3}$.
ganse	$x_{1}$ [observer] senses/detects/notices stimulus $x_{2}$ (object/nu) by means $x_{3}$ under conditions $x_{4}$.
ganti	$x_{1}$ is a/the testes/ovary/testicle/scrotum/balls/gonad/stamen/pistil [body-part] of $x_{2}$, gender $x_{3}$.
ganxo	$x_{1}$ is a/the anus/anal orifice/asshole/arsehole [body-part] of $x_{2}$; [metaphor: exit, waste exit].
ganzu	$x_{1}$ organizes $x_{2}$ [relative chaos] into $x_{3}$ [ordered/organized result] by system/principle(s) $x_{4}$.
gapci	$x_{1}$ is gaseous/fumes/a gas/vapor of material/composition including $x_{2}$, under conditions $x_{3}$.
gapru	$x_{1}$ is directly/vertically above/upwards-from $x_{2}$ in gravity/frame of reference $x_{3}$.
garna	$x_{1}$ is a rail/railing/bar [tool] supporting/restraining $x_{2}$, of material $x_{3}$.
gasnu	$x_{1}$ [person/agent] is an agentive cause of event $x_{2}$; $x_{1}$ does/brings about $x_{2}$.
gasta	$x_{1}$ is a quantity of/is made of/contains steel of composition including $x_{2}$.
genja	$x_{1}$ is a root [body-part] of plant/species $x_{2}$; [metaphor: immobile, supporting, nourishing].
gento	$x_{1}$ reflects Argentinian culture/nationality in aspect $x_{2}$.
genxu	$x_{1}$ is a hook/crook [shape/form] of material $x_{2}$.
gerku	$x_{1}$ is a dog/canine/[bitch] of species/breed $x_{2}$.
gerna	$x_{1}$ is the grammar/rules/defining form of language $x_{2}$ for structure/text $x_{3}$.
gidva	$x_{1}$ (person/object/event) guides/conducts/pilots/leads $x_{2}$ (active participants) in/at $x_{3}$ (event).
gigdo	$x_{1}$ is a billion [British milliard] [$10^9$] of $x_{2}$ in dimension/aspect $x_{3}$ (default is units).
ginka	$x_{1}$ is a camp/encampment/temporary residence of $x_{2}$ at location $x_{3}$.
girzu	$x_{1}$ is group/cluster/team showing common property (ka) $x_{2}$ due to set $x_{3}$ linked by relations $x_{4}$.
gismu	$x_{1}$ is a (Lojban) root word expressing relation $x_{2}$ among argument roles $x_{3}$, with affix(es) $x_{4}$.
glare	$x_{1}$ is hot/[warm] by standard $x_{2}$.
gleki	$x_{1}$ is happy/merry/glad/gleeful about $x_{2}$ (event/state).
gletu	$x_{1}$ copulates/mates/has coitus/sexual intercourse with $x_{2}$.
glico	$x_{1}$ is English/pertains to English-speaking culture in aspect $x_{2}$.
gluta	$x_{1}$ is a mitten/glove [hand and lower arm garment] of material $x_{2}$.
gocti	$x_{1}$ is $10^{-24}$ of $x_{2}$ in dimension/aspect $x_{3}$ (default is units).
gotro	$x_{1}$ is $10^{24}$ of $x_{2}$ in dimension/aspect $x_{3}$ (default is units).
gradu	$x_{1}$ [magnitude] is a unit/degree of/on scale/reference standard $x_{2}$ (si'o) measuring property $x_{3}$.
grake	$x_{1}$ is $x_{2}$ gram(s) [metric unit] in mass (default is 1) by standard $x_{3}$.
grana	$x_{1}$ is a rod/pole/staff/stick/cane [shape/form] of material $x_{2}$.
grasu	$x_{1}$ is a quantity of/is made of/contains grease/fat/oil from source $x_{2}$.
greku	$x_{1}$ is a frame/structure/skeleton/outline supporting/load-bearing/determining the form of $x_{2}$.
grusi	$x_{1}$ is gray [color adjective].
grute	$x_{1}$ is a fruit [body-part] of species $x_{2}$.
gubni	$x_{1}$ is public/un-hidden/open/jointly available to/owned by all among community $x_{2}$ (mass).
gugde	$x_{1}$ is the country of peoples $x_{2}$ with land/territory $x_{3}$; (people/territory relationship).
gundi	$x_{1}$ is industry/industrial/systematic manufacturing activity producing $x_{2}$ by process/means $x_{3}$.
gunka	$x_{1}$ [person] labors/works on/at $x_{2}$ [activity] with goal/objective $x_{3}$.
gunma	$x_{1}$ is a mass/team/aggregate/whole, together composed of components $x_{2}$, considered jointly.
gunro	$x_{1}$ rolls/trundles on/against surface $x_{2}$ rotating on axis/axle $x_{3}$; $x_{1}$ is a roller.
gunse	$x_{1}$ is a goose/[gander] of species/breed $x_{2}$.
gunta	$x_{1}$ (person/mass) attacks/invades/commits aggression upon victim $x_{2}$ with goal/objective $x_{3}$.
gurni	$x_{1}$ is grain/[British: corn]/cereal from plant/species $x_{2}$.
guska	$x_{1}$ blade/scraper/erosive scrapes/erodes/abrades $x_{2}$ from $x_{3}$.
gusni	$x_1$ [energy] is light/illumination illuminating $x_2$ from light source $x_3$.
gusta	$x_{1}$ is a restaurant/cafe/diner serving type-of-food $x_{2}$ to audience $x_{3}$.
gutci	$x_{1}$ is $x_{2}$ (default 1) short local distance unit(s) [non-metric], standard $x_{3}$, $x_{4}$ subunits.
gutra	$x_{1}$ is a/the womb/uterus [body-part] of $x_{2}$; [metaphor: nourishing, protective, giving birth].
guzme	$x_{1}$ is a melon/squash [fruit/plant] of species/strain $x_{2}$.
jabre	$x_{1}$ brakes/causes to slow motion/activity $x_{2}$ with device/mechanism/principle $x_{3}$.
jadni	$x_{1}$ (object) adorns/decorates $x_{2}$; $x_{1}$ is an adornment/decoration of $x_{2}$; $x_{2}$ is fancy/decorated.
jakne	$x_{1}$ is a rocket [vehicle] propelled by jet expelling $x_{2}$ carrying payload $x_{3}$.
jalge	$x_{1}$ (action/event/state) is a result/outcome/conclusion of antecedent $x_{2}$ (event/state/process).
jalna	$x_{1}$ is a quantity of/contains/is made of starch from source $x_{2}$ of composition including $x_{3}$.
jalra	$x_{1}$ is a cockroach/orthopteran/termite of order/species/breed $x_{2}$.
jamfu	$x_{1}$ is a/the foot [body-part] of $x_{2}$; [metaphor: lowest portion] (adjective:) $x_{1}$ is pedal.
jamna	$x_{1}$ (person/mass) wars against $x_{2}$ over territory/matter $x_{3}$; $x_{1}$ is at war with $x_{2}$.
janbe	$x_{1}$ is a bell/chime/[tuning fork] [tuned percussion instrument] producing sound/note $x_{2}$.
janco	$x_{1}$ is a/the shoulder/hip/joint [body-part] attaching limb/extremity $x_{2}$ to body $x_{3}$.
janli	$x_{1}$ collides with/crashes/bumps/runs into $x_{2}$.
jansu	$x_{1}$ is a diplomat/consul representing polity $x_{2}$ in/at negotiation $x_{3}$ for function/purpose $x_{4}$.
janta	$x_{1}$ is an account/bill/invoice for goods/services $x_{2}$, billed to $x_{3}$ by $x_{4}$.
jarbu	$x_{1}$ is a suburban area of city/metropolis $x_{2}$.
jarco	$x_{1}$ (agent) shows/exhibits/displays/[reveals]/demonstrates $x_{2}$ (property) to audience $x_{3}$.
jarki	$x_{1}$ is narrow in dimension $x_{2}$ [2nd most significant dimension] by standard $x_{3}$.
jaspu	$x_{1}$ is a passport issued to $x_{2}$ (person) by authority $x_{3}$ allowing $x_{4}$ (activity).
jatna	$x_{1}$ is captain/commander/leader/in-charge/boss of vehicle/domain $x_{2}$.
javni	$x_{1}$ is a rule prescribing/mandating/requiring $x_{2}$ (event/state) within system/community $x_{3}$.
jbama	$x_{1}$ is a bomb/explosive device with explosive material/principle $x_{2}$.
jbari	$x_{1}$ is a berry (fruit/plant) of plant/species $x_{2}$.
jbena	$x_{1}$ is born to $x_{2}$ at time $x_{3}$ [birthday] and place $x_{4}$ [birthplace]; $x_{1}$ is native to (fo) $x_{4}$.
jbera	$x_{1}$ (agent) borrows/temporarily takes/assumes $x_{2}$ (object) from source $x_{3}$ for interval $x_{4}$.
jbini	$x_{1}$ is between/among set of points/bounds/limits $x_{2}$ (set)/amidst mass $x_{2}$ in property $x_{3}$ (ka).
jdari	$x_{1}$ is firm/hard/resistant/unyielding to force $x_{2}$ under conditions $x_{3}$.
jdice	$x_{1}$ (person) decides/makes decision $x_{2}$ (du'u) about matter $x_{3}$ (event/state).
jdika	$x_{1}$ (experiencer) decreases/contracts/is reduced/diminished in property/quantity $x_{2}$ by amount $x_{3}$.
jdima	$x_{1}$ [amount] is the price of $x_{2}$ to purchaser/consumer $x_{3}$ set by vendor $x_{4}$.
jdini	$x_{1}$ is money/currency issued by $x_{2}$; (adjective:) $x_{1}$ is financial/monetary/pecuniary/fiscal.
jduli	$x_{1}$ is a quantity of jelly/semisolid [texture] of material/composition including $x_{2}$.
jecta	$x_{1}$ is a polity/state governing territory/domain $x_{2}$; [government/territory relationship].
jeftu	$x_{1}$ is $x_{2}$ weeks in duration (default is 1 week) by standard $x_{3}$.
jegvo	$x_{1}$ pertains to the common Judeo-Christian-Moslem (Abrahamic) culture/religion/nationality in aspect $x_{2}$.
jelca	$x_{1}$ burns/[ignites/is flammable/inflammable] at temperature $x_{2}$ in atmosphere $x_{3}$.
jemna	$x_{1}$ is a gem/polished stone/pearl of type $x_{2}$ from gemstone/material/source $x_{3}$.
jenca	$x_{1}$ (event) shocks/stuns $x_{2}$.
jendu	$x_{1}$ is an axle/spindle [tool] on which $x_{2}$ rotates, of material/properties $x_{3}$.
jenmi	$x_{1}$ (mass) is an army serving group/community $x_{2}$ (mass) in function $x_{3}$ (activity).
jerna	$x_{1}$ (agent/person) earns/[deserves/merits] wages/salary/pay $x_{2}$ for work/service $x_{3}$ (activity).
jersi	$x_{1}$ chases/pursues/(physically) follows after $x_{2}$; volition is not implied for $x_{1}$ or $x_{2}$.
jerxo	$x_{1}$ reflects Algerian culture/nationality in aspect $x_{2}$.
jesni	$x_{1}$ is a needle [pointed shape/form, not tool] of material $x_{2}$.
jetce	$x_{1}$ is a jet [expelled stream] of material $x_{2}$ expelled from $x_{3}$.
jetnu	$x_{1}$ (du'u) is true/truth by standard/epistemology/metaphysics $x_{2}$.
jgalu	$x_{1}$ is a/the claw/nail/talon [body-part] of $x_{2}$; [metaphor: pointed, penetrating, physical weapon].
jganu	$x_{1}$ is an angle [2-dimensional shape/form] from vertex $x_{2}$ subtended by lateral [segment] $x_{3}$.
jgari	$x_{1}$ grasps/holds/clutches/seizes/grips/[hugs] $x_{2}$ with $x_{3}$ (part of $x_{1}$) at locus $x_{4}$ (part of $x_{2}$).
jgena	$x_{1}$ is a knot/tangle in/between $x_{2}$ (object/jo'u-objects).
jgina	$x_{1}$ is a gene of creature [or locus on creature] $x_{2}$ determining trait/process $x_{3}$.
jgira	$x_{1}$ (person) feels/has pride in/about $x_{2}$ (abstraction).
jgita	$x_{1}$ is guitar/violin/fiddle/harp [stringed musical instrument] with actuator/plectrum/bow $x_{2}$.
jibni	$x_{1}$ is near/close to/approximates $x_{2}$ in property/quantity $x_{3}$ (ka/ni).
jibri	$x_{1}$ is a job/occupation/employment/vocation (a type of work regularly done for pay) of person $x_{2}$.
jicla	$x_{1}$ (object, or event: force) stirs/mixes/[roils/agitates] fluid (gas/liquid) $x_{2}$.
jicmu	$x_{1}$ is a basis/foundation/underlying or fundamental principle of $x_{2}$; $x_{1}$ is at the bottom of $x_{2}$.
jijnu	$x_{1}$ (person) intuits $x_{2}$ (du'u) about subject $x_{3}$; [epistemology].
jikca	$x_{1}$ interacts/behaves socially with $x_{2}$; $x_{1}$ socializes with/is sociable towards $x_{2}$.
jikru	$x_{1}$ is made of/contains/is a quantity of liquor/spirits distilled from $x_{2}$.
jilka	$x_{1}$ is a quantity of/contains/is made of alkali/base of composition including $x_{2}$.
jilra	$x_{1}$ (person) is jealous of/envies $x_{2}$ (person) about/for $x_{3}$ (property - ka).
jimca	$x_{1}$ is a branch/bough/limb of $x_{2}$; $x_{2}$ forks into branches $x_{1}$; [preferred over metaphorical birka].
jimpe	$x_{1}$ understands/comprehends fact/truth $x_{2}$ (du'u) about subject $x_{3}$; $x_{1}$ understands (fi) $x_{3}$.
jimte	$x_{1}$ is a limit/extreme/bound/border/[confinement] of $x_{2}$ in property/domain $x_{3}$.
jinci	$x_{1}$ is a pair of shears/scissors for cutting $x_{2}$.
jinga	$x_{1}$ (person/team) wins/gains prize $x_{2}$ from/over $x_{3}$ [competitors/losers] in competition $x_{4}$.
jinku	$x_{1}$ is a vaccine/immune-system stimulant protecting $x_{2}$ against disease $x_{3}$ introduced by method $x_{4}$.
jinme	$x_{1}$ is a quantity of/contains/is made of made of metal of composition including $x_{2}$.
jinru	$x_{1}$ (object/person) is immersed/submerged/bathes in liquid $x_{2}$.
jinsa	$x_{1}$ (object) is clean/pure of material/contaminant/dirt $x_{2}$ by standard $x_{3}$.
jinto	$x_{1}$ is a well/spring of fluid $x_{2}$ at location $x_{3}$.
jinvi	$x_{1}$ thinks/opines $x_{2}$ [opinion] (du'u) is true about subject/issue $x_{3}$ on grounds $x_{4}$.
jinzi	$x_{1}$ (property - ka) is an innate/inherent/intrinsic/natural property/quality/aspect of $x_{2}$.
jipci	$x_{1}$ is a chicken/[hen/cock/rooster]/small fowl [a type of bird] of species/breed $x_{2}$.
jipno	$x_{1}$ is a tip/point/vertex/extremity/end [0-dimension shape/form] on object $x_{2}$ at locus $x_{3}$.
jirna	$x_{1}$ is a/the horn [body-part] of $x_{2}$; [metaphor: pointed extremity].
jisra	$x_{1}$ is made of/contains/is a quantity of juice/nectar from-source/of-type $x_{2}$.
jitfa	$x_{1}$ (du'u) is false/is an untruth by standard/epistemology/metaphysics $x_{2}$.
jitro	$x_{1}$ has control over/harnesses/manages/directs/conducts $x_{2}$ in $x_{3}$ (activity/event/performance).
jivbu	$x_{1}$ weaves $x_{2}$ from material/[yarn] $x_{3}$.
jivna	$x_{1}$ competes/vies with opponent $x_{2}$ in contest/competition $x_{3}$ (event) for gain $x_{4}$; $x_{1}$ rivals $x_{2}$.
jmaji	$x_{1}$ (mass/jo'u) gathers/collects at location $x_{2}$ from locations $x_{3}$ (mass/jo'u).
jmifa	$x_{1}$ is a shoal [shallow hazard]/reef of material $x_{2}$ in body of water $x_{3}$.
jmina	$x_{1}$ adds/combines $x_{2}$ to/with $x_{3}$, with result $x_{4}$; $x_{1}$ augments $x_{2}$ by amount $x_{3}$.
jmive	$x_{1}$ lives/is alive by standard $x_{2}$; $x_{1}$ is an organism/living thing.
jordo	$x_{1}$ reflects Jordanian culture/nationality in aspect $x_{2}$.
jorne	$x_{1}$ is joined to/connects to/is united with $x_{2}$ at common locus $x_{3}$; $x_{1}$ and $x_{2}$ are a union.
jubme	$x_{1}$ is a table/flat solid upper surface of material $x_{2}$, supported by legs/base/pedestal $x_{3}$.
judri	$x_{1}$ is an address of/are coordinates of $x_{2}$ in system $x_{3}$.
jufra	$x_{1}$ (text) is a sentence/statement about $x_{2}$ [topic/subject/predicate/focus] in language $x_{3}$.
jukni	$x_{1}$ is a spider/arachnid/crustacean/crab/lobster/non-insect arthropod of species/breed $x_{2}$.
jukpa	$x_{1}$ cooks/prepares food-for-eating $x_{2}$ by recipe/method $x_{3}$ (process).
julne	$x_{1}$ is a net/filter allowing passage of $x_{2}$, prohibiting passage of $x_{3}$, netting properties $x_{4}$.
jundi	$x_{1}$ is attentive towards/attends/tends/pays attention to object/affair $x_{2}$.
jungo	$x_{1}$ reflects Chinese [Mandarin, Cantonese, Wu, etc.] culture/nationality/language in aspect $x_{2}$.
junla	$x_{1}$ is clock/watch/timer measuring time units $x_{2}$ to precision $x_{3}$ with timing mechanism/method $x_{4}$.
junri	$x_{1}$ (person) is serious/earnest/has gravity about $x_{2}$ (event/state/activity).
junta	$x_{1}$ is the weight of object $x_{2}$ in [gravitational or other force] field $x_{3}$.
jurme	$x_{1}$ is a bacterium/germ/microbe/protozoan/amoeba [1-celled life] of species/defining property $x_{2}$.
jursa	$x_{1}$ (event/action/state) is severe/harsh to $x_{2}$ [victim/experiencer].
jutsi	$x_{1}$ is a species of genus $x_{2}$, family $x_{3}$, etc.; [open-ended tree-structure categorization].
juxre	$x_{1}$ (action) is clumsy/awkward by standard $x_{2}$.
jvinu	$x_{1}$ is the view/scene/panorama/sight/prospect of $x_{2}$ (object/location) from point-of-view $x_{3}$.
kabri	$x_{1}$ is a cup/glass/tumbler/mug/vessel/[bowl] containing contents $x_{2}$, and of material $x_{3}$.
kacma	$x_{1}$ is a camera/photographic equipment recording illumination type $x_{2}$ images to medium $x_{3}$.
kadno	$x_{1}$ reflects Canadian culture/nationality in aspect $x_{2}$.
kafke	$x_{1}$ coughs/farts/burps up/out $x_{2}$ [predominantly gaseous] from orifice $x_{3}$.
kagni	$x_{1}$ is a company/corporation/firm/partnership chartered by authority $x_{2}$ for purpose $x_{3}$.
kajde	$x_{1}$ (event/experience) warns/cautions $x_{2}$ (person) of/about danger $x_{3}$ (event/state/property).
kajna	$x_{1}$ is a shelf/counter/bar in/on/attached to supporting object $x_{2}$, for purpose $x_{3}$.
kakne	$x_{1}$ is able to do/be/capable of doing/being $x_{2}$ (event/state) under conditions $x_{3}$ (event/state).
kakpa	$x_{1}$ (agent) digs $x_{2}$ [material] up/out of $x_{3}$ [source/hole] with limbs/tool(s) $x_{4}$.
kalci	$x_{1}$ is a/the feces/excrement/dung/shit of $x_{2}$ (animal/person); (adjective:) $x_{1}$ is fecal (matter).
kalri	$x_{1}$ (portal/passage/entrance-way) is open/ajar/not shut permitting passage/access to $x_{2}$ by $x_{3}$.
kalsa	$x_{1}$ is chaotic/disordered in property/aspect $x_{2}$ (ka).
kalte	$x_{1}$ hunts/stalks prey/quarry/game $x_{2}$ for purpose $x_{3}$.
kamju	$x_{1}$ is a column/pillar of material $x_{2}$.
kamni	$x_{1}$ (mass) is a committee with task/purpose $x_{2}$ of body $x_{3}$.
kampu	$x_{1}$ (property - ka) is common/general/universal among members of set $x_{2}$ (complete set).
kanba	$x_{1}$ is a goat/angora/[billy-goat/kid] of species/breed $x_{2}$.
kancu	$x_{1}$ (agent) counts the number in set $x_{2}$ to be $x_{3}$ [number/count] counting [off] by units $x_{4}$.
kandi	$x_{1}$ is dim/dull/pale/non-intense in property $x_{2}$ (ka) as received/measured by observer $x_{3}$.
kanji	$x_{1}$ calculates/reckons/computes $x_{2}$ [value (ni)/state] from data $x_{3}$ by process $x_{4}$.
kanla	$x_{1}$ is a/the eye [body-part] of $x_{2}$; [metaphor: sensory apparatus]; (adjective:) $x_{1}$ is ocular.
kanro	$x_{1}$ is healthy/fit/well/in good health by standard $x_{2}$.
kansa	$x_{1}$ is with/accompanies/is a companion of $x_{2}$, in state/condition/enterprise $x_{3}$ (event/state).
kantu	$x_{1}$ is a quantum/ray/elementary particle/smallest measurable increment of property/activity $x_{2}$.
kanxe	$x_{1}$ is a conjunction, stating that $x_{2}$ (du'u) and $x_{3}$ (du'u) are both true.
karbi	$x_{1}$ [observer] compares $x_{2}$ with $x_{3}$ in property $x_{4}$ (ka), determining comparison $x_{5}$ (state).
karce	$x_{1}$ is a car/automobile/truck/van [a wheeled motor vehicle] for carrying $x_{2}$, propelled by $x_{3}$
karda	$x_{1}$ is a card [small nearly-2-dimensional shape/form] of material $x_{2}$, shape $x_{3}$.
kargu	$x_{1}$ (object/commodity/property/event) is costly/expensive/dear to $x_{2}$ by standard $x_{3}$.
karli	$x_{1}$ is a collar/ring/belt/band around/surrounding $x_{2}$ made of material $x_{3}$.
karni	$x_{1}$ is a journal/periodical/magazine/[newspaper] with content $x_{2}$ published by $x_{3}$ for audience $x_{4}$.
katna	$x_{1}$ (tool/blade/force) cuts [through]/splits/divides $x_{2}$ (object) into pieces $x_{3}$.
kavbu	$x_{1}$ captures/catches/apprehends/seizes/nabs $x_{2}$ with trap/restraint $x_{3}$.
kecti	$x_{1}$ (person) pities/feels sorry for $x_{2}$ (person) about $x_{3}$ (abstraction).
kelci	$x_{1}$ [agent] plays with plaything/toy $x_{2}$.
kelvo	$x_{1}$ is $x_{2}$ degree(s) Kelvin [metric unit] in temperature (default is 1) by standard $x_{3}$.
kenra	$x_{1}$ is a cancer [malignant disease] in $x_{2}$.
kensa	$x_{1}$ is outer space near/associated with celestial body/region $x_{2}$.
kerfa	$x_{1}$ is a/the hair/fur [body-part] of $x_{2}$ at body location $x_{3}$.
kerlo	$x_{1}$ is a/the ear [body-part] of $x_{2}$; [metaphor: sensory apparatus, information gathering].
ketco	$x_{1}$ reflects South American culture/nationality/geography in aspect $x_{2}$.
kevna	$x_{1}$ is a cavity/hole/hollow/cavern in $x_{2}$; $x_{1}$ is concave within $x_{2}$; $x_{2}$ is hollow at locus $x_{1}$.
kicne	$x_{1}$ cushions $x_{2}$ with material $x_{3}$; $x_{1}$ is a cushion/pillow/pad [for $x_{2}$] of padding material $x_{3}$.
kijno	$x_{1}$ is a quantity of/contains/is made of oxygen (O); [metaphor: supporting life/combustion].
kilto	$x_{1}$ is a thousand [1000; $10^3$] of $x_{2}$ in dimension/aspect $x_{3}$ (default is units).
kinli	$x_{1}$ is sharp/keen at locus $x_{2}$.
kisto	$x_{1}$ reflects Pakistani/Pashto culture/nationality/language in aspect $x_{2}$.
klaji	$x_{1}$ is a street/avenue/lane/drive/cul-de-sac/way/alley/[road] at $x_{2}$ accessing $x_{3}$.
klaku	$x_{1}$ weeps/cries tears $x_{2}$ about/for reason $x_{3}$ (event/state).
klama	$x_{1}$ comes/goes to destination $x_{2}$ from origin $x_{3}$ via route $x_{4}$ using means/vehicle $x_{5}$.
klani	$x_{1}$ is a quantity quantified/measured/enumerated by $x_{2}$ (quantifier) on scale $x_{3}$ (si'o).
klesi	$x_{1}$ (mass/si'o) is a class/category/subgroup/subset within $x_{2}$ with defining property $x_{3}$ (ka).
klina	$x_{1}$ (object/medium) is clear/transparent/without obstacle to in-the-clear $x_{2}$ [transmission].
kliru	$x_{1}$ is a quantity of/contains/is made of halogen of type $x_{2}$ [chlorine, fluorine, iodine, etc.].
kliti	$x_{1}$ is a quantity of/contains/is made of clay [moist, clammy dirt] of composition including $x_{2}$.
klupe	$x_{1}$ is a screw [fastener] for purpose $x_{2}$, threads [pitch, material] $x_{3}$, frame [size, material] $x_{4}$.
kluza	$x_{1}$ (obj.) is loose/bloused/not tight on $x_{2}$ (obj.) at locus $x_{3}$.
kobli	$x_{1}$ is a quantity of cabbage/lettuce/leafy vegetable of species/strain $x_{2}$.
kojna	$x_{1}$ is a corner/point/at-least-3-dimensional [solid] angle [shape/form] in/on $x_{2}$, of material $x_{3}$.
kolme	$x_{1}$ is a quantity of/contains/is made of coal/peat/anthracite/bitumen from source $x_{2}$.
komcu	$x_{1}$ is a comb [many-needled shape] of material $x_{2}$ with tines/needles $x_{3}$.
konju	$x_{1}$ is a cone [shape/form] of material $x_{2}$ with vertex $x_{3}$.
korbi	$x_{1}$ is an edge/margin/border/curb/boundary of $x_{2}$ next-to/bordering-on $x_{3}$.
korcu	(adjective:) $x_{1}$ is bent/crooked/not straight or direct/[twisted]/folded.
korka	$x_{1}$ is a quantity of/contains/is made of cork/bark from tree/species $x_{2}$; [material].
kosta	$x_{1}$ is a coat/jacket/sweater/cloak/[cape/shawl/pullover] [extra outer garment] of material $x_{2}$.
kramu	$x_{1}$ is $x_{2}$ local area unit(s) [non-metric] (default 1) by standard $x_{3}$, $x_{4}$ subunits.
krasi	$x_{1}$ (site/event) is a source/start/beginning/origin of $x_{2}$ (object/event/process).
krati	$x_{1}$ represents/is an agent/proxy/stands-in for [absent] $x_{2}$ in matter(s)/function(s) $x_{3}$.
krefu	$x_{1}$ (event) is the $x_{3}$'rd recurrence/repetition of $x_{2}$ (abstract); $x_{2}$ happens again in [form] $x_{1}$.
krici	$x_{1}$ believes [regardless of evidence/proof] belief/creed $x_{2}$ (du'u) is true/assumed about subject $x_{3}$.
krili	$x_{1}$ is a quantity of/contains/is made of crystal of composition $x_{2}$ in form/arrangement $x_{3}$.
krinu	$x_{1}$ (event/state) is a reason/justification/explanation for/causing/permitting $x_{2}$ (event/state).
krixa	$x_{1}$ cries out/yells/howls sound $x_{2}$; $x_{1}$ is a crier.
kruca	$x_{1}$ intersects/crosses/traverses $x_{2}$ at locus $x_{3}$.
kruji	$x_{1}$ is made of/contains/is a quantity of cream/emulsion/puree [consistency] of composition $x_{2}$.
kruvi	$x_{1}$ is a curve/turn/bend in $x_{2}$, at locus $x_{3}$, and defined by set of points/properties $x_{4}$.
kubli	$x_{1}$ is a cube/regular polyhedron/polygon of dimensions $x_{2}$ (def. 3), surfaces/sides $x_{3}$ (def. 6).
kucli	$x_{1}$ is curious/wonders about/is interested in/[inquisitive about] $x_{2}$ (object/abstract).
kufra	$x_{1}$ feels comfort/is comfortable with conditions/environmental property(ies) $x_{2}$.
kukte	$x_{1}$ is delicious/tasty/delightful to observer/sense $x_{2}$ [person, or sensory activity].
kulnu	$x_{1}$ [mass of ideas, customs, skills, arts] is culture of nation/ethos $x_{2}$ (mass); $x_{1}$ is ethnic.
kumfa	$x_{1}$ is a room of/in structure $x_{2}$ surrounded by partitions/walls/ceiling/floor $x_{3}$ (mass/jo'u).
kumte	$x_{1}$ is a camel/llama/alpaca/vicuna/dromedary of species/breed $x_{2}$.
kunra	$x_{1}$ is/contains/is made from a mineral/ore of type/metal $x_{2}$ mined from location/lode/mine $x_{3}$.
kunti	$x_{1}$ [container] is empty/vacant of $x_{2}$ [material]; $x_{1}$ is hollow.
kurfa	$x_{1}$ is a right-angled shape/form defined by set of vertices $x_{2}$, dimensions $x_{3}$ (default 2).
kurji	$x_{1}$ takes-care-of/looks after/attends to/provides for/is caretaker for $x_{2}$ (object/event/person).
kurki	$x_{1}$ is bitter/acrid/sharply disagreeable to observer/sense $x_{2}$.
kuspe	$x_{1}$ ranges/extends/spans/persists/reaches across/over interval/gap/area/scope/extent/range $x_{2}$.
kusru	$x_{1}$ (person) is cruel/mean/unkind to victim $x_{2}$.
labno	$x_{1}$ is a wolf/lupine of species/breed $x_{2}$.
lacpu	$x_{1}$ pulls/tugs/draws/drags $x_{2}$ by handle/at locus $x_{3}$.
lacri	$x_{1}$ relies/depends/counts on/trusts $x_{2}$ to bring about/ensure/maintain $x_{3}$ (event/state).
ladru	$x_{1}$ is made of/contains/is a quantity of milk from source $x_{2}$; (adjective:) $x_{1}$ is lactic/dairy.
lafti	$x_{1}$ (force) lifts/applies raising/supporting force to $x_{2}$ at locus $x_{3}$ in gravity well $x_{4}$.
lakne	$x_{1}$ (event/state/property) is probable/likely under conditions $x_{2}$.
lakse	$x_{1}$ is quantity of wax [substance especially soft/moldable when warm] from source $x_{2}$.
lalxu	$x_{1}$ is a lake/lagoon/pool at site/within land mass $x_{2}$.
lamji	$x_{1}$ is adjacent/beside/next to/in contact with $x_{2}$ in property/sequence $x_{3}$ in direction $x_{4}$.
lanbi	$x_{1}$ is a quantity of protein/albumin of type $x_{2}$ composed of amino acids (sequence/jo'u) $x_{3}$ .
lanci	$x_{1}$ is a flag/banner/standard of/symbolizing $x_{2}$ with pattern(s) $x_{3}$ on material $x_{4}$.
lanka	$x_{1}$ is a basket with contents $x_{2}$, woven from material $x_{3}$.
lanli	$x_{1}$ analyzes/examines-in-detail $x_{2}$ by method/technique/system $x_{3}$ [process/activity].
lanme	$x_{1}$ is a sheep/[lamb/ewe/ram] of species/breed $x_{2}$ of flock $x_{3}$.
lante	$x_{1}$ is a can/tightly sealed/pre-sealed container for perishable contents $x_{2}$, made of $x_{3}$.
lanxe	$x_{1}$ is in balance/equilibrium under forces $x_{2}$ (mass).
lanzu	$x_{1}$ (mass) is a family with members including $x_{2}$ bonded/tied/joined according to standard $x_{3}$.
larcu	$x_{1}$ (process) is an art [creative application] of craft/skill $x_{2}$ (idea/activity).
lasna	$x_{1}$ (agent) fastens/connects/attaches/binds/lashes $x_{2}$ to $x_{3}$ with fastener $x_{4}$.
lastu	$x_{1}$ is a quantity of/contains/is made of brass [copper/zinc alloy] of composition including $x_{2}$.
latmo	$x_{1}$ reflects Latin/Roman/Romance culture/empire/language in aspect $x_{2}$.
latna	$x_{1}$ is a lotus, plant/flower/herb of species/strain $x_{2}$ symbolizing $x_{3}$ to culture/religion $x_{4}$.
lazni	$x_{1}$ (person) is lazy/avoiding work/effort concerning action $x_{2}$.
lebna	$x_{1}$ takes/gets/gains/obtains/seizes/[removes] $x_{2}$ (object/property) from $x_{3}$ (possessor).
lenjo	$x_{1}$ is a lens/glass [focussing shape/form] focussing $x_{2}$ to focus/foci $x_{3}$ by means/material $x_{4}$.
lenku	$x_{1}$ is cold/cool by standard $x_{2}$.
lerci	$x_{1}$ (event) is late by standard $x_{2}$.
lerfu	$x_{1}$ (la'e zo BY/word-bu) is a letter/digit/symbol in alphabet/character-set $x_{2}$ representing $x_{3}$.
libjo	$x_{1}$ reflects Libyan culture/nationality in aspect $x_{2}$.
lidne	$x_{1}$ precedes/leads $x_{2}$ in sequence $x_{3}$; $x_{1}$ is former/preceding/previous; $x_{2}$ is latter/following.
lifri	$x_{1}$ [person/passive/state] undergoes/experiences $x_{2}$ (event/experience); $x_{2}$ happens to $x_{1}$.
lijda	$x_{1}$ is a religion of believers including $x_{2}$ sharing common beliefs/practices/tenets including $x_{3}$.
limna	$x_{1}$ (agent) swims in fluid $x_{2}$.
lindi	$x_{1}$ is lightning/electrical arc/thunderbolt striking at/extending to $x_{2}$ from $x_{3}$.
linji	$x_{1}$ is a line/among lines [1-dimensional shape/form] defined by set of points $x_{2}$.
linsi	$x_{1}$ is a length of chain/links of material $x_{2}$ with link properties $x_{3}$.
linto	$x_{1}$ is light in mass/weight by standard $x_{2}$.
lisri	$x_1$ is a story/tale/yarn/narrative about plot/subject/moral $x_2$ by storyteller $x_3$ to audience $x_4$.
liste	$x_{1}$ (physical object) is a list/catalog/register of sequence/set $x_{2}$ in order $x_{3}$ in medium $x_{4}$.
litce	$x_{1}$ is $x_{2}$ liter(s) [metric unit] in volume (default is 1) by standard $x_{3}$.
litki	$x_{1}$ is liquid/fluid, of composition/material including $x_{2}$, under conditions $x_{3}$.
litru	$x_{1}$ travels/journeys/goes/moves via route $x_{2}$ using means/vehicle $x_{3}$; $x_{1}$ is a traveller.
livga	$x_{1}$ is a/the liver [body-part] of $x_{2}$.
livla	$x_{1}$ is a fuel/energy-source for powering $x_{2}$.
logji	$x_{1}$ [rules/methods] is a logic for deducing/concluding/inferring/reasoning to/about $x_{2}$ (du'u).
lojbo	$x_{1}$ reflects [Loglandic]/Lojbanic language/culture/nationality/community in aspect $x_{2}$.
loldi	$x_{1}$ is a floor/bottom/ground of $x_{2}$.
lorxu	$x_{1}$ is a fox [bushy-tailed wild dog/canine] of species/breed $x_{2}$.
lubno	$x_{1}$ reflects Lebanese culture/nationality in aspect $x_{2}$.
lujvo	$x_{1}$ (text) is a compound predicate word with meaning $x_{2}$ and arguments $x_{3}$ built from metaphor $x_{4}$.
lumci	$x_{1}$ (agent) washes/cleanses $x_{2}$ of soil/contaminant $x_{3}$ in/with cleaning material(s) $x_{4}$.
lunbe	$x_{1}$ is bare/naked/nude; $x_{1}$ is without cover/clothes/[protection].
lunra	$x_{1}$ is Earth's moon (default); $x_{1}$ is a major natural satellite/moon of planet $x_{2}$.
lunsa	$x_{1}$ condenses/liquefies on/into $x_{2}$ at temperature $x_{3}$, pressure $x_{4}$; $x_{1}$ is dew/condensate on $x_{2}$.
mabla	$x_1$ is execrable/deplorable/wretched/shitty/awful/rotten/miserable/contemptible/crappy/inferior/low-quality in property $x_2$ by standard $x_3$; $x_1$ stinks/sucks in aspect $x_2$ according to $x_3$.
mabru	$x_{1}$ is a mammal/'animal'/beast of species $x_{2}$.
macnu	$x_{1}$ (event/action/process) is manual [not automatic] in function $x_{2}$ under conditions $x_{3}$.
makcu	$x_{1}$ is mature/ripe/fully-grown/adult in development-quality $x_{2}$ (ka).
makfa	$x_{1}$ is magic/supernatural/sorcery/witchcraft/wizardry to $x_{2}$, performed by person/force/deity $x_{3}$.
maksi	$x_{1}$ is magnetic [adjective] producing magnetic field $x_{2}$.
malsi	$x_{1}$ is a temple/church/sanctuary/synagogue/shrine of religion $x_{2}$ at location/serving area $x_{3}$.
mamta	$x_{1}$ is a mother of $x_{2}$; $x_{1}$ bears/mothers/acts maternally toward $x_{2}$; [not necessarily biological].
manci	$x_{1}$ feels wonder/awe/marvels about $x_{2}$.
manfo	$x_{1}$ (object/event) is uniform/homogeneous in property $x_{2}$ (ka).
manku	$x_{1}$ is dark/lacking in illumination.
manri	$x_{1}$ is a frame of reference/standard for observing/measuring/determining $x_{2}$, with/by rules $x_{3}$.
mansa	$x_{1}$ satisfies evaluator $x_{2}$ in property (ka)/state $x_{3}$.
manti	$x_{1}$ is an ant of species/breed $x_{2}$.
mapku	$x_{1}$ is a cap/hat/crown/helmet/piece of headgear [head-top garment] of material $x_{2}$.
mapni	$x_{1}$ is a quantity of/contains/is made of cotton [type of fabric/material].
mapti	$x_{1}$ fits/matches/suits/is compatible/appropriate/corresponds to/with $x_{2}$ in property/aspect $x_{3}$.
marbi	$x_{1}$ is a shelter/haven/refuge/retreat/harbor for/protecting $x_{2}$ from danger/threat $x_{3}$.
marce	$x_{1}$ is a vehicle/mode of transport carrying $x_{2}$ in/on surface/medium $x_{3}$, propelled by $x_{4}$.
marde	$x_{1}$ are the ethics/morals/moral standards/ethical standards of $x_{2}$ (ind./mass) about situation $x_{3}$.
margu	$x_{1}$ is a quantity of/contains/made of mercury/quicksilver; [metaphor: fluid metal; temperature].
marji	$x_{1}$ is material/stuff/matter of type/composition including $x_{2}$ in shape/form $x_{3}$.
marna	$x_{1}$ is a quantity of hemp/marijuana/jute of species/strain $x_{2}$.
marxa	$x_{1}$ [force] mashes/crushes/squashes/smashes $x_{2}$ into pulp/mash/crumbs/deformed mass $x_{3}$.
masno	$x_{1}$ is slow/sluggish at doing/being/bringing about $x_{2}$ (event/state).
masti	$x_{1}$ is $x_{2}$ months in duration (default is 1 month) by month standard $x_{3}$.
matci	$x_{1}$ is a mat/pad/mattress/pallet [flat, soft, dense form] of material $x_{2}$.
matli	$x_{1}$ is a quantity of/contains/is made of linen/flax [type of fabric/material].
matne	$x_{1}$ is a quantity of/contains butter/oleo/margarine/shortening from source $x_{2}$.
matra	$x_{1}$ is a motor/engine, driving/propelling/providing power to $x_{2}$.
mavji	$x_{1}$ is a quantity of oats [grain] of species/strain $x_{2}$.
maxri	$x_{1}$ is a quantity of wheat [grain] of species/strain $x_{2}$.
mebri	$x_{1}$ is a/the brow/forehead [projecting flat/smooth head/body-part] of $x_{2}$.
megdo	$x_{1}$ is a million [$10^6$] of $x_{2}$ in dimension/aspect $x_{3}$ (default is units).
mekso	$x_{1}$ [quantifier/expression] is a mathematical expression interpreted under rules/convention $x_{2}$.
melbi	$x_{1}$ is beautiful/pleasant to $x_{2}$ in aspect $x_{3}$ (ka) by aesthetic standard $x_{4}$.
meljo	$x_{1}$ reflects Malaysian/Malay culture/nationality/language in aspect $x_{2}$.
menli	$x_{1}$ is a mind/intellect/psyche/mentality/[consciousness] of body $x_{2}$.
mensi	$x_{1}$ is a sister of/sororal to $x_{2}$ by bond/tie/standard/parent(s) $x_{3}$; [not necessarily biological].
mentu	$x_{1}$ is $x_{2}$ minutes in duration (default is 1 minute) by standard $x_{3}$.
merko	$x_{1}$ pertains to USA/American culture/nationality/dialect in aspect $x_{2}$.
merli	$x_{1}$ (agent) measures/evaluates $x_{2}$ [quantity] as $x_{3}$ units on scale $x_{4}$ (si'o), with accuracy $x_{5}$.
mexno	$x_{1}$ reflects Mexican culture/nationality in aspect $x_{2}$.
midju	$x_{1}$ is in/at the middle/center/midpoint/[is a focus] of $x_{2}$; (adjective:) $x_{1}$ is central.
mifra	$x_{1}$ is encoded/cipher text of plain-text $x_{2}$ by code/coding system $x_{3}$; $x_{1}$ is in code; $x_{3}$ is a code.
mikce	$x_{1}$ doctors/treats/nurses/[cures]/is physician/midwife to $x_{2}$ for ailment $x_{3}$ by treatment/cure $x_{4}$.
mikri	$x_{1}$ is a millionth [$10^{-6}$] of $x_{2}$ in dimension/aspect $x_{3}$ (default is units).
milti	$x_{1}$ is a thousandth [1/1000; $10^{-3}$] of $x_{2}$ in dimension/aspect $x_{3}$ (default is units).
milxe	$x_{1}$ is mild/non-extreme/gentle/middling/somewhat in property $x_{2}$ (ka); $x_{1}$ is not very $x_{2}$.
minde	$x_{1}$ issues commands/orders to $x_{2}$ for result $x_{3}$ (event/state) to happen; $x_{3}$ is commanded to occur.
minji	$x_{1}$ is a machine for use/function $x_{2}$; [automated apparatus, without direct function control].
minli	$x_{1}$ is $x_{2}$ (default 1) long local distance unit(s) [non-metric], $x_{3}$ subunits, standard $x_{4}$.
minra	$x_{1}$ reflects/mirrors/echoes $x_{2}$ [object/radiation] to observer/point $x_{3}$ as $x_{4}$; $x_{2}$ bounces on $x_{1}$.
mintu	$x_{1}$ is the same/identical thing as $x_{2}$ by standard $x_{3}$; ($x_{1}$ and $x_{2}$ interchangeable).
mipri	$x_{1}$ keeps $x_{2}$ secret/hidden from $x_{3}$ by method $x_{4}$; $x_{2}$ is a secret; $x_{1}$ hides/conceals $x_{2}$.
mirli	$x_{1}$ is a deer/elk/moose/[hart/stag/doe] of species/breed $x_{2}$.
misno	$x_{1}$ (person/object/event) is famous/renowned/is a celebrity among community of persons $x_{2}$ (mass).
misro	$x_{1}$ reflects Egyptian culture/nationality in aspect $x_{2}$.
mitre	$x_{1}$ is $x_{2}$ meter(s) [metric unit] in length (default 1) measured in direction $x_{3}$ by standard $x_{4}$.
mixre	$x_{1}$ (mass) is a mixture/blend/colloid/commingling with ingredients including $x_{2}$.
mlana	$x_{1}$ is to the side of/lateral to $x_{2}$ and facing $x_{3}$ from point of view/in-frame-of-reference $x_{4}$.
mlatu	$x_{1}$ is a cat/[puss/pussy/kitten] [feline animal] of species/breed $x_{2}$; (adjective:) $x_{1}$ is feline.
mleca	$x_{1}$ is less than $x_{2}$ in property/quantity $x_{3}$ (ka/ni) by amount $x_{4}$.
mledi	$x_{1}$ is a mold/fungus/mushrooms/truffles of species/strain $x_{2}$ parasitic/growing on $x_{3}$.
mluni	$x_{1}$ is a satellite/moon orbiting $x_{2}$ with characteristics $x_{3}$, orbital parameters $x_{4}$.
mokca	$x_{1}$ is a point/instant/moment [0-dimensional shape/form] in/on/at time/place $x_{2}$.
moklu	$x_{1}$ is a/the mouth/oral cavity [body-part] of $x_{2}$; (metaphor: entrance/intake for consumption).
molki	$x_{1}$ is a mill/foundry/industrial plant/[assembly line] performing process $x_{2}$.
molro	$x_{1}$ is $x_{2}$ mole(s) [metric unit] in substance (default is 1) by standard $x_{3}$.
morji	$x_{1}$ remembers/recalls/recollects fact(s)/memory $x_{2}$ (du'u) about subject $x_{3}$.
morko	$x_{1}$ reflects Moroccan culture/nationality in aspect $x_{2}$.
morna	$x_{1}$ is/reflects/represents a pattern of forms/events $x_{2}$ arranged according to structure $x_{3}$.
morsi	$x_{1}$ is dead/has ceased to be alive.
mosra	$x_{1}$ is friction [force opposing motion] due to contact/rubbing between $x_{2}$ and $x_{3}$; (fe) $x_{2}$ rubs $x_{3}$.
mraji	$x_{1}$ is a quantity of rye [grain] of species/strain $x_{2}$.
mrilu	$x_{1}$ mails/posts [transfer via intermediary service] $x_{2}$ to recipient address $x_{3}$ from mailbox/post office/sender address $x_{4}$ by carrier/network/system $x_{5}$.
mruli	$x_{1}$ [tool] is a hammer for/hammers $x_{2}$ [target] consisting of weight/head $x_{3}$ propelled by $x_{4}$.
mucti	$x_{1}$ is immaterial/not physical/without material form.
mudri	$x_{1}$ is a quantity of/is made of/contains wood/lumber from tree(s) of type/species $x_{2}$.
mukti	$x_{1}$ (action/event/state) motivates/is a motive/incentive for action/event $x_{2}$, per volition of $x_{3}$.
mulno	$x_{1}$ (event) is complete/done/finished; $x_{1}$ (object) has become whole in property $x_{2}$ by standard $x_{3}$.
munje	$x_{1}$ is a universe/cosmos [complete and ordered entirety] of domain/sphere $x_{2}$ defined by rules $x_{3}$.
mupli	$x_{1}$ is an example/sample/specimen/instance/case/illustration of common property(s) $x_{2}$ of set $x_{3}$.
murse	$x_{1}$ is the [astronomical] twilight/dawn/dusk/half-light/glimmering of day $x_{2}$ at location $x_{3}$.
murta	$x_{1}$ is a curtain/blinds/drapes for covering/obscuring aperture $x_{2}$, and made of material $x_{3}$.
muslo	$x_{1}$ pertains to the Islamic/Moslem/Koranic [Quranic] culture/religion/nation in aspect $x_{2}$.
mutce	$x_{1}$ is much/extreme in property $x_{2}$ (ka), towards $x_{3}$ extreme/direction; $x_{1}$ is, in $x_{2}$, very $x_{3}$.
muvdu	$x_{1}$ (object) moves to destination/receiver $x_{2}$ [away] from origin $x_{3}$ over path/route $x_{4}$.
muzga	$x_{1}$ is a museum for preserving [and possibly exhibiting] $x_{2}$ at location $x_{3}$.
nabmi	$x_{1}$ (event/state) is a problem to/encountered by $x_{2}$ in situation/task/inquiry $x_{3}$.
nakni	$x_1$ is a male/buck of species $x_2$ evidencing masculine physical/biological/genetic trait(s) $x_3$ (ka); $x_1$ is masculine.
nalci	$x_{1}$ is a/the wing [body-part] of $x_{2}$; [metaphor: lateral supporting surface].
namcu	$x_{1}$ (li) is a number/quantifier/digit/value/figure (noun); refers to the value and not the symbol.
nanba	$x_{1}$ is a quantity of/contains bread [leavened or unleavened] made from grains $x_{2}$.
nanca	$x_{1}$ is $x_{2}$ years in duration (default is 1 year) by standard $x_{3}$; (adjective:) $x_{1}$ is annual.
nandu	$x_{1}$ is difficult/hard/challenging for $x_{2}$ under conditions $x_{3}$; $x_{1}$ challenges (non-agentive) $x_{2}$.
nanla	$x_{1}$ is a boy/lad [young male person] of age $x_{2}$ immature by standard $x_{3}$.
nanmu	$x_{1}$ is a man/men; $x_{1}$ is a male humanoid person [not necessarily adult].
nanvi	$x_{1}$ is a billionth/thousand-millionth [$10^{-9}$] of $x_{2}$ in dimension/aspect $x_{3}$ (default is units).
narge	$x_{1}$ is a nut [body-part: hard-shelled fruit] from plant/species $x_{2}$ with shell $x_{3}$ and kernel $x_{4}$.
narju	$x_{1}$ is orange [color adjective].
natfe	$x_{1}$ (du'u) contradicts/denies/refutes/negates $x_{2}$ (du'u) under rules/logic $x_{3}$.
natmi	$x_{1}$ is a nation/ethnic group of peoples $x_{2}$; [people sharing a history/culture].
navni	$x_1$ is a quantity of/contains/is made of noble gas of type $x_2$ [helium/neon/argon/krypton/xenon/radon].
naxle	$x_{1}$ is a canal/channel to $x_{2}$ from $x_{3}$ with route $x_{4}$.
nazbi	$x_{1}$ is the nose [body-part] of $x_{2}$ with nostril(s)/nasal passage(s) $x_{3}$; [metaphor: protrusion].
nejni	$x_{1}$ is energy of type $x_{2}$ in form $x_{3}$.
nelci	$x_{1}$ is fond of/likes/has a taste for $x_{2}$ (object/state).
nenri	$x_{1}$ is in/inside/within $x_{2}$; $x_{1}$ is on the inside/interior of $x_{2}$ [totally within the bounds of $x_{2}$].
nibli	$x_{1}$ logically necessitates/entails/implies action/event/state $x_{2}$ under rules/logic system $x_{3}$.
nicte	$x_{1}$ is a nighttime of day $x_{2}$ at location $x_{3}$; (adjective:) $x_{1}$ is at night/nocturnal.
nikle	$x_{1}$ is made of/contains/is a quantity of nickel/other metal resistant to oxidation.
nilce	$x_{1}$ [furniture items] furnishes $x_{2}$ [location] serving purpose/function $x_{3}$.
nimre	$x_{1}$ is a quantity of citrus [fruit/tree, etc.] of species/strain $x_{2}$.
ninmu	$x_{1}$ is a woman/women; $x_{1}$ is a female humanoid person [not necessarily adult].
nirna	$x_{1}$ is a nerve/neuron [body-part] of $x_{2}$; [metaphor: information/control network connection].
nitcu	$x_{1}$ needs/requires/is dependent on/[wants] necessity $x_{2}$ for purpose/action/stage of process $x_{3}$.
nivji	$x_{1}$ (agent) knits $x_{2}$ [cloth/object] from yarn/thread $x_{3}$.
nixli	$x_{1}$ is a girl [young female person] of age $x_{2}$ immature by standard $x_{3}$.
nobli	$x_{1}$ is noble/aristocratic/elite/high-born/titled in/under culture/society/standard $x_{2}$.
notci	$x_{1}$ is a message/notice/memorandum about subject $x_{2}$ from author $x_{3}$ to intended audience $x_{4}$.
nukni	$x_{1}$ is magenta/fuchsia/purplish-red [color adjective].
nupre	$x_{1}$ (agent) promises/commits/assures/threatens $x_{2}$ (event/state) to $x_{3}$ [beneficiary/victim].
nurma	$x_{1}$ is a rural/rustic/pastoral area of $x_{2}$; $x_{1}$ is in the country.
nutli	$x_{1}$ is neutral/not taking sides/medial/not towards any extreme on scale/in dissension $x_{2}$.
nuzba	$x_{1}$ (du'u) is news/tidings/new information about subject $x_{2}$ from source $x_{3}$, to observer $x_{4}$.
pacna	$x_{1}$ hopes/wishes for/desires $x_{2}$ (event), expected likelihood $x_{3}$ (0-1); $x_{1}$ hopes that $x_{2}$ happens.
pagbu	$x_{1}$ is a part/component/piece/portion/segment of $x_{2}$ [where $x_{2}$ is a whole/mass]; $x_{2}$ is partly $x_{1}$.
pagre	$x_{1}$ passes through/penetrates barrier/medium/portal $x_{2}$ to destination side $x_{3}$ from origin side $x_{4}$.
pajni	$x_{1}$ judges/referees/arbitrates/is a judge determining/deciding matter $x_{2}$ (abstract).
palci	$x_{1}$ is evil/depraved/wicked [morally bad] by standard $x_{2}$.
palku	$x_{1}$ are pants/trousers/slacks/leggings [legged garment] of material $x_{2}$.
palne	$x_{1}$ is a tray/platter/flat container [pan/sheet/griddle] of contents $x_{2}$, and made of material $x_{3}$.
palta	$x_{1}$ is a plate/dish/platter/saucer [flat/mildly concave food service bed] made of material $x_{2}$.
pambe	$x_{1}$ is a pump/injector [tool/apparatus] pumping/inserting fluid $x_{2}$ to $x_{3}$ from $x_{4}$ by means $x_{5}$.
panci	$x_{1}$ is an odor/fragrance/scent/smell emitted by $x_{2}$ and detected by observer/sensor $x_{3}$.
pandi	$x_{1}$ (agent) punctuates $x_{2}$ (expression) with symbol/word $x_{3}$ with syntactic/semantic effect $x_{4}$.
panje	$x_{1}$ is a quantity of/contains/is made of sponge/porous material.
panka	$x_{1}$ is a park/land reserve managed by community/polity/company $x_{2}$ for purpose $x_{3}$.
panlo	$x_{1}$ is a slice [thin flat portion] of $x_{2}$ (mass).
panpi	$x_{1}$ is at peace with $x_{2}$.
panra	$x_{1}$ parallels $x_{2}$ differing only in property $x_{3}$ (ka; jo'u/fa'u term) by standard/geometry $x_{4}$.
pante	$x_{1}$ protests/objects to/complains about $x_{2}$ (event/state) to audience $x_{3}$ with action $x_{4}$.
panzi	$x_{1}$ is a [biological] offspring/child/kid/hybrid of parent(s) $x_{2}$; (adjective:) $x_{1}$ is filial.
papri	$x_{1}$ is a [physical] page/leaf of book/document/bound mass of pages $x_{2}$.
parbi	$x_{1}$ (me'o, fraction) is a ratio/rate of $x_{2}$ (quantity) with respect to $x_{3}$ (quantity), [$x_{2}$:$x_{3}$].
pastu	$x_{1}$ is a robe/tunic/gown/cloak/dress/[coveralls] [a long/full body garment] of material $x_{2}$.
patfu	$x_{1}$ is a father of $x_{2}$; $x_{1}$ begets/sires/acts paternal towards $x_{2}$; [not necessarily biological].
patlu	$x_{1}$ is a potato [an edible tuber] of variety/cultivar $x_{2}$.
patxu	$x_{1}$ is a pot/kettle/urn/tub/sink, a deep container for contents $x_{2}$, of material/properties $x_{3}$.
pelji	$x_{1}$ is paper from source $x_{2}$.
pelxu	$x_{1}$ is yellow/golden [color adjective].
pemci	$x_{1}$ is a poem/verse about plot/theme/subject/pattern $x_{2}$ by author $x_{3}$ for intended audience $x_{4}$.
penbi	$x_{1}$ is a pen using ink $x_{2}$ applied by process $x_{3}$.
pencu	$x_{1}$ (agent) touches $x_{2}$ with $x_{3}$ [a locus on $x_{1}$ or an instrument] at $x_{4}$ [a locus on $x_{2}$].
pendo	$x_{1}$ is/acts as a friend of/to $x_{2}$ (experiencer); $x_{2}$ befriends $x_{1}$.
penmi	$x_{1}$ meets/encounters $x_{2}$ at/in location $x_{3}$.
pensi	$x_{1}$ thinks/considers/cogitates/reasons/is pensive about/reflects upon subject/concept $x_{2}$.
perli	$x_{1}$ is a pear [fruit] of species/strain $x_{2}$.
pesxu	$x_{1}$ is paste/pulp/dough/mash/mud/slurry [soft, smooth-textured, moist solid] of composition $x_{2}$.
petso	$x_{1}$ is $10^{15}$ of $x_{2}$ in dimension/aspect $x_{3}$ (default is units).
pezli	$x_{1}$ is a leaf of plant $x_{2}$; $x_{1}$ is foliage of $x_{2}$.
picti	$x_{1}$ is a trillionth [$10^{-12}$] of $x_{2}$ in dimension/aspect $x_{3}$ (default is units).
pijne	$x_{1}$ is a pin/peg (needle-shaped tool) for fastening to/piercing $x_{2}$, of material/properties $x_{3}$.
pikci	$x_{1}$ begs/pleads/supplicates/entreats/implores/beseeches/prays [asks with humility] $x_{2}$ for $x_{3}$.
pikta	$x_{1}$ is a ticket entitling $x_{2}$ to entitlement/privilege $x_{3}$ (event/state) under conditions $x_{4}$.
pilji	$x_{1}$ is the product/total/result of factors/multiplicands ($x_{2}$ and $x_{3}$) $x_{2}$ multiplied by $x_{3}$.
pilka	$x_{1}$ is a crust/rind/peel/skin/hide/outer cover of $x_{2}$.
pilno	$x_{1}$ uses/employs $x_{2}$ [tool, apparatus, machine, agent, acting entity, material] for purpose $x_{3}$.
pimlu	$x_{1}$ is a/the feather/plume(s)/plumage [body-part] of animal/species $x_{2}$.
pinca	$x_{1}$ is a/the urine/piss/pee of $x_{2}$.
pindi	$x_{1}$ is poor/indigent/impoverished/lacking in goods/possessions/property $x_{2}$.
pinfu	$x_{1}$ is a prisoner/captive of $x_{2}$, restrained/held/confined by means/force $x_{3}$.
pinji	$x_{1}$ is a/the clitoris/penis [projecting reproductive organ; body-part] of $x_{2}$.
pinka	$x_{1}$ (text) is a comment/remark/observation about subject $x_{2}$ expressed by $x_{3}$ to audience $x_{4}$.
pinsi	$x_{1}$ is a pencil/crayon/stylus applying lead/marking material $x_{2}$, frame/support [of material] $x_{3}$.
pinta	$x_{1}$ is flat/level/horizontal in gravity/frame of reference $x_{2}$.
pinxe	$x_{1}$ (agent) drinks/imbibes beverage/drink/liquid refreshment $x_{2}$ from/out-of container/source $x_{3}$.
pipno	$x_{1}$ is a piano/harpsichord/synthesizer/organ; a keyboard musical instrument.
pixra	$x_{1}$ is a picture/illustration representing/showing $x_{2}$, made by artist $x_{3}$ in medium $x_{4}$.
plana	$x_{1}$ is plump/fat/obese [excessively thick/bulbous/swollen] by standard $x_{2}$.
platu	$x_{1}$ (agent) plans/designs/plots plan/arrangement/plot/[schematic] $x_{2}$ for state/process $x_{3}$.
pleji	$x_{1}$ pays/compensates/remunerates/[rewards] payment $x_{2}$ to recipient/payee $x_{3}$ for goods/services $x_{4}$.
plibu	$x_{1}$ is a/the pubic area/external genitalia [body-part] of $x_{2}$.
plini	$x_{1}$ is a planet revolving around $x_{2}$ with planetary characteristics $x_{3}$, orbital parameters $x_{4}$.
plipe	$x_{1}$ (agent/object) leaps/jumps/springs/bounds to $x_{2}$ from $x_{3}$ reaching height $x_{4}$ propelled by $x_{5}$.
plise	$x_{1}$ is an apple [fruit] of species/strain $x_{2}$.
plita	$x_{1}$ is a plane [2-dimensional shape/form] defined by points $x_{2}$ (set); $x_{1}$ is flat/[smooth].
plixa	$x_{1}$ (agent) plows/furrows/tills [cuts into and turns up] $x_{2}$ with tool $x_{3}$ propelled by $x_{4}$.
pluja	$x_{1}$ is complex/complicated/involved in aspect/property $x_{2}$ (ka) by standard $x_{3}$.
pluka	$x_{1}$ (event/state) seems pleasant to/pleases $x_{2}$ under conditions $x_{3}$.
pluta	$x_1$ is a route/path/way/course/track to $x_2$ from $x_3$ via/defined by points including $x_4$ (set).
polje	$x_{1}$ (force) folds/creases $x_{2}$ at locus/loci/forming crease(s)/bend(s) $x_{3}$.
polno	$x_{1}$ reflects Polynesian/Oceanian (geographic region) culture/nationality/languages in aspect $x_{2}$.
ponjo	$x_{1}$ reflects Japanese culture/nationality/language in aspect $x_{2}$.
ponse	$x_{1}$ possesses/owns/has $x_{2}$ under law/custom $x_{3}$; $x_{1}$ is owner/proprietor of $x_{2}$ under $x_{3}$.
porpi	$x_{1}$ breaks/fractures/shatters/[splits/splinters/cracks] into pieces $x_{2}$.
porsi	$x_{1}$ [ordered set] is sequenced/ordered/listed by comparison/rules $x_{2}$ on unordered set $x_{3}$.
porto	$x_{1}$ reflects Portuguese culture/nationality/language in aspect $x_{2}$.
prali	$x_{1}$ is a profit/gain/benefit/advantage to $x_{2}$ accruing/resulting from activity/process $x_{3}$.
prami	$x_{1}$ loves/feels strong affectionate devotion towards $x_{2}$ (object/state).
prane	$x_{1}$ is perfect/ideal/archetypical/faultless/flawless/un-improvable in property/aspect $x_{2}$ (ka).
preja	$x_{1}$ spreads/expands over/into $x_{2}$ from initial state $x_{3}$.
prenu	$x_{1}$ is a person/people (noun) [not necessarily human]; $x_{1}$ displays personality/a persona.
preti	$x_{1}$ (quoted text) is a question/query about subject $x_{2}$ by questioner $x_{3}$ to audience $x_{4}$.
prije	$x_{1}$ is wise/sage about matter $x_{2}$ (abstraction) to observer $x_{3}$.
prina	$x_{1}$ is a print/impression/image on/in surface $x_{2}$ of/made by/using tool/press/implement/object $x_{3}$.
pritu	$x_{1}$ is to the right/right-hand side of $x_{2}$ which faces/in-frame-of-reference $x_{3}$.
prosa	$x_{1}$ is prose about plot/theme/subject $x_{2}$ by author $x_{3}$ for intended audience $x_{4}$.
pruce	$x_{1}$ is a process with inputs $x_{2}$, outputs/results $x_{3}$, passing through steps/stages $x_{4}$.
pruni	(adjective:) $x_{1}$ is elastic/springy.
pruxi	$x_{1}$ is spiritual/pertains to the soul in nature [either energy or being]; $x_{1}$ is ghostly/ethereal.
pulce	$x_{1}$ is dust/precipitate [suspensible solid] from $x_{2}$ in medium/on surface $x_{3}$.
pulji	$x_{1}$ is a police officer/[enforcer/vigilante] enforcing law(s)/rule(s)/order $x_{2}$.
pulni	$x_{1}$ is a pulley [tool] for performing action/function $x_{2}$ rotating on axle $x_{3}$.
punji	$x_{1}$ (agent) puts/places/sets $x_{2}$ on/at surface/locus $x_{3}$.
punli	$x_{1}$ is a swelling/protrusion/convexity [shape/form] at/in/on $x_{2}$, of material $x_{3}$.
purci	$x_{1}$ is in the past of/earlier than/before $x_{2}$ in time sequence; $x_{1}$ is former; $x_{2}$ is latter.
purdi	$x_{1}$ is a garden/tended/cultivated field of family/community/farmer $x_{2}$ growing plants/crop $x_{3}$.
purmo	$x_{1}$ is a powder of material $x_{2}$.
racli	$x_{1}$ (action/activity/behavior) is sane/rational by standard $x_{2}$.
ractu	$x_{1}$ is a rabbit/hare/[doe] of species/breed $x_{2}$.
radno	$x_{1}$ is $x_{2}$ radian(s) [metric unit] in angular measure (default is 1) by standard $x_{3}$.
rafsi	$x_{1}$ is an affix/suffix/prefix/combining-form for word/concept $x_{2}$, form/properties $x_{3}$, language $x_{4}$.
ragve	$x_{1}$ is located across/on the other side of gap/boundary $x_{2}$ from $x_{3}$; $x_{1}$ is opposite (fi) $x_{3}$.
rakso	$x_{1}$ reflects Iraqi culture/nationality in aspect $x_{2}$.
raktu	$x_{1}$ (object/person/event/situation) troubles/disturbs $x_{2}$ (person) causing problem(s) $x_{3}$.
ralci	$x_{1}$ is delicate/fragile/subtle/refined in property $x_{2}$ (ka).
ralju	$x_{1}$ is principal/chief/leader/main/[staple], most significant among $x_{2}$ (set) in property $x_{3}$ (ka).
ralte	$x_{1}$ retains/keeps/holds $x_{2}$ in its possession.
randa	$x_{1}$ yields/gives way/surrenders to $x_{2}$ (force/agent) under conditions $x_{3}$.
rango	$x_{1}$ is a/the body organ [body-part] of body/species $x_{2}$ performing function $x_{3}$.
ranji	$x_{1}$ (event/state) continues/persists over interval $x_{2}$; $x_{1}$ (property - ka) is continuous over $x_{2}$.
ranmi	$x_{1}$ is a myth/legend, a culturally significant story about $x_{2}$ in mythos $x_{3}$ of culture $x_{4}$.
ransu	$x_{1}$ is a quantity of/contains/is made of bronze of composition including $x_{2}$.
ranti	$x_{1}$ is soft/malleable/moldable/yielding to force $x_{2}$ in conditions $x_{3}$.
ranxi	$x_{1}$ is ironic(al)/contrary to expectation $x_{2}$ in state/property/aspect $x_{3}$.
rapli	$x_{1}$ [action] repeats/is repeated for a total of $x_{2}$ (quantity) occurrences.
rarna	$x_{1}$ is natural/spontaneous/instinctive, not [consciously] caused by person(s).
ratcu	$x_{1}$ is a rat of species/breed $x_{2}$.
ratni	$x_{1}$ is an atom of element/atomic number $x_{2}$ of isotope number/atomic weight $x_{3}$.
rebla	$x_{1}$ is a/the tail/appendix [body-part] of $x_{2}$; [metaphor: trailing, following portion/appendage].
rectu	$x_{1}$ is a quantity of/contains meat/flesh from source/animal $x_{2}$.
remna	$x_{1}$ is a human/human being/man (non-specific gender-free sense); (adjective:) $x_{1}$ is human.
renro	$x_{1}$ throws/launches/casts/hurls $x_{2}$ to/at/in direction $x_{3}$ (propulsion derives internally to $x_{1}$).
renvi	$x_{1}$ survives/endures/undergoes/abides/lasts/persists through $x_{2}$ for interval/duration $x_{3}$.
respa	$x_{1}$ is a reptile of species/breed $x_{2}$.
ricfu	$x_{1}$ is rich/wealthy in goods/possessions/property/aspect $x_{2}$.
rigni	$x_{1}$ is repugnant to/causes disgust to $x_{2}$ under conditions $x_{3}$.
rijno	$x_{1}$ is made of/contains/is a quantity of silver/argentum (Ag); [metaphor: valuable, tarnishing].
rilti	$x_{1}$ (sequence/non-text quote) is a rhythm/beat of music/expressive form $x_{2}$.
rimni	$x_{1}$ rhymes/alliterates with $x_{2}$ in language/phonetics $x_{3}$, matching sound correspondence $x_{4}$ (ka).
rinci	$x_{1}$ liquid/fluid drains/strains/flushes from source $x_{2}$ through drain/strainer $x_{3}$ by force $x_{4}$.
rinju	$x_{1}$ is restrained/held [back]/constrained/kept by restraint $x_{2}$ against $x_{3}$ (event).
rinka	$x_{1}$ (event/state) effects/physically causes effect $x_{2}$ (event/state) under conditions $x_{3}$.
rinsa	$x_{1}$ (agent) greets/hails/[welcomes/says hello to]/responds to arrival of $x_{2}$ in manner $x_{3}$ (action).
rirci	$x_{1}$ [member] is rare/unusual/uncommon/atypical in property $x_{2}$ (ka) among members of $x_{3}$ (set).
rirni	$x_{1}$ is a parent of/raises/rears $x_{2}$; $x_{1}$ mentors/acts parental toward child/protege $x_{2}$.
rirxe	$x_{1}$ is a river of land mass $x_{2}$, draining watershed $x_{3}$ into $x_{4}$/terminating at $x_{4}$.
rismi	$x_{1}$ is a quantity of rice [a type of grain] of strain/cultivar $x_{2}$.
risna	$x_{1}$ is a/the heart [body-part] of $x_{2}$; [emotional/shape metaphors are NOT culturally neutral].
ritli	$x_{1}$ is a rite/ceremony/ritual for purpose/goal $x_{2}$, by custom/in community $x_{3}$, with form/rules $x_{4}$.
rivbi	$x_{1}$ avoids/evades/shuns/escapes/skirts [fate] $x_{2}$ (event) through action/state $x_{3}$ (event).
rokci	$x_{1}$ is a quantity of/is made of/contains rock/stone of type/composition $x_{2}$ from location $x_{3}$.
romge	$x_{1}$ is a highly reflective/polished non-tarnishing metallic surface, of metal $x_{2}$ [often chromium].
ropno	$x_{1}$ reflects European culture/nationality/geography/Indo-European languages in aspect $x_{2}$.
rorci	$x_{1}$ engenders/procreates/begets $x_{2}$ with coparent $x_{3}$.
rotsu	$x_{1}$ is thick in dimension/direction $x_{2}$ by standard $x_{3}$; [relatively long in smallest dimension].
rozgu	$x_{1}$ is a rose [flower - characterized by prickly stem/fragrance] of species/strain $x_{2}$.
ruble	$x_{1}$ is weak/feeble/frail in property/quality/aspect $x_{2}$ (ka) by standard $x_{3}$.
rufsu	$x_{1}$ is rough/coarse/uneven/[grainy/scabrous/rugged] in texture/regularity.
runme	$x_{1}$ melts [becomes liquid from solid state] at temperature $x_{2}$ and pressure $x_{3}$.
runta	$x_{1}$ dissolves in solvent $x_{2}$ forming solution/[suspension] $x_{3}$ under conditions $x_{4}$.
rupnu	$x_{1}$ is measured in major-money-units (dollar/yuan/ruble) as $x_{2}$ (quantity), monetary system $x_{3}$.
rusko	$x_{1}$ reflects Russian culture/nationality/language in aspect $x_{2}$.
rutni	$x_{1}$ is an artifact; $x_{1}$ is artificial; $x_{1}$ is made/caused by people/se kulnu $x_{2}$; $x_{1}$ is man-made.
sabji	$x_{1}$ [source] provides/supplies/furnishes $x_{2}$ [supply/commodity] to $x_{3}$ [recipient].
sabnu	$x_{1}$ is a cabin of vehicle $x_{2}$.
sacki	$x_{1}$ is a match [incendiary device] made of $x_{2}$.
saclu	$x_{1}$ (me'o) is the [decimal/binary] equivalent of fractional $x_{2}$ (me'o) in base $x_{3}$ (quantity).
sadjo	$x_{1}$ reflects Saudi Arabian culture/nationality in aspect $x_{2}$.
sakci	$x_{1}$ sucks/is suction/vacuum/relatively low pressure of fluid/gas $x_{2}$ relative to high pressure $x_{3}$.
sakli	$x_{1}$ slides/slips/glides on $x_{2}$.
sakta	$x_{1}$ is made of/contains/is a quantity of sugar [sweet edible] from source $x_{2}$ of composition $x_{3}$.
salci	$x_{1}$ celebrates/recognizes/honors $x_{2}$ (event/abstract) with activity/[party] $x_{3}$.
salpo	$x_{1}$ is sloped/inclined/slanted/aslant with angle $x_{2}$ to horizon/frame $x_{3}$.
salta	$x_{1}$ (mass) is a quantity of salad [food] with ingredients/components including $x_{2}$.
samcu	$x_{1}$ is a quantity of cassava/taro/manioc/tapioca/yam [edible starchy root] of species/strain $x_{2}$.
sampu	$x_{1}$ is simple/unmixed/uncomplicated in property $x_{2}$ (ka).
sance	$x_{1}$ is sound produced/emitted by $x_{2}$.
sanga	$x_{1}$ sings/chants $x_{2}$ [song/hymn/melody/melodic sounds] to audience $x_{3}$.
sanji	$x_{1}$ is conscious/aware of $x_{2}$ (object/abstract); $x_{1}$ discerns/recognizes $x_{2}$ (object/abstract).
sanli	$x_{1}$ stands [is vertically oriented] on surface $x_{2}$ supported by limbs/support/pedestal $x_{3}$.
sanmi	$x_{1}$ (mass) is a meal composed of dishes including $x_{2}$.
sanso	$x_{1}$ is a sauce/topping/gravy/frosting for use with $x_{2}$, containing ingredient(s) including $x_{3}$.
santa	$x_{1}$ is an umbrella/parasol shielding $x_{2}$ from $x_{3}$, made of material $x_{4}$, supported by $x_{5}$.
sarcu	$x_{1}$ (abstract) is necessary/required for continuing state/process $x_{2}$ under conditions $x_{3}$.
sarji	$x_{1}$ supports/holds up/is underpinning of/[helps] $x_{2}$ against force/opposition $x_{3}$ with/by means $x_{4}$.
sarlu	$x_{1}$ is a spiral/helix/whorl/[vortex] [shape/form] with limits $x_{2}$, of dimensionality $x_{3}$.
sarxe	$x_{1}$ is harmonious/concordant/in agreement/concord with $x_{2}$ in property $x_{3}$ (ka).
saske	$x_{1}$ (mass of facts) is science of/about subject matter $x_{2}$ based on methodology $x_{3}$.
satci	$x_{1}$ [measurement/match] is exact/precise to precision $x_{2}$ in property/quantity $x_{3}$ (ka/ni).
satre	$x_{1}$ (agent) strokes/rubs/pets $x_{2}$ with $x_{3}$.
savru	$x_{1}$ is a noise/din/clamor [sensory input without useful information] to $x_{2}$ via sensory channel $x_{3}$.
sazri	$x_{1}$ operates/drives/runs $x_{2}$ [apparatus/machine] with goal/objective/use/end/function $x_{3}$.
sefta	$x_{1}$ is surface/face [bounded shape/form] of [higher-dimension] object $x_{2}$, on side $x_{3}$, edges $x_{4}$.
selci	$x_{1}$ is a cell/atom/unit/molecule of $x_{2}$; $x_{1}$ is an indivisible, most basic subunit of $x_{2}$.
selfu	$x_{1}$ (agent) serves $x_{2}$ with service $x_{3}$ (activity); $x_{1}$ is a servant (noun) of $x_{2}$ performing $x_{3}$.
semto	$x_{1}$ reflects Semitic [metaphor: Middle-Eastern] language/culture/nationality in aspect $x_{2}$.
senci	$x_{1}$ sneezes (intransitive verb).
senpi	$x_{1}$ doubts/is dubious/doubtful/skeptical/questions that $x_{2}$ (du'u) is true.
senta	$x_{1}$ is a layer/stratum [shape/form] of $x_{2}$ [material] within structure/continuum/composite $x_{3}$.
senva	$x_{1}$ dreams about/that $x_{2}$ (fact/idea/event/state); $x_{2}$ is a dream/reverie of $x_{1}$.
sepli	$x_{1}$ is apart/separate from $x_{2}$, separated by partition/wall/gap/interval/separating medium $x_{3}$.
serti	$x_{1}$ are stairs/stairway/steps for climbing structure $x_{2}$ with steps $x_{3}$.
setca	$x_{1}$ (agent) inserts/interposes/puts/deposits $x_{2}$ into interior $x_{3}$/into among/between members of $x_{3}$.
sevzi	$x_{1}$ is a self/ego/id/identity-image of $x_{2}$.
sfani	$x_{1}$ is a fly [a small non-stinging flying insect] of species/breed $x_{2}$.
sfasa	$x_{1}$ (agent) punishes $x_{2}$ for infraction $x_{3}$ (event/state/action) with punishment $x_{4}$ (event/state).
sfofa	$x_{1}$ is a sofa/couch (noun).
sfubu	$x_{1}$ dives/swoops [manner of controlled falling] to $x_{2}$ from $x_{3}$.
siclu	$x_{1}$ [sound source] whistles/makes whistling sound/note/tone/melody $x_{2}$.
sicni	$x_{1}$ is a coin/token/is specie issued by $x_{2}$ having value $x_{3}$ of composition including $x_{4}$.
sidbo	$x_{1}$ (idea abstract) is an idea/concept/thought about $x_{2}$ (object/abstract) by thinker $x_{3}$.
sidju	$x_{1}$ helps/assists/aids object/person $x_{2}$ do/achieve/maintain event/activity $x_{3}$.
sigja	$x_{1}$ is a cigar/cigarette/cigarillo made from tobacco/smokable substance $x_{2}$ by $x_{3}$.
silka	$x_{1}$ is a quantity of/contains/is made of silk produced by $x_{2}$.
silna	$x_{1}$ is a portion/quantity of salt from source $x_{2}$, of composition including $x_{3}$.
simlu	$x_{1}$ seems/appears to have property(ies) $x_{2}$ to observer $x_{3}$ under conditions $x_{4}$.
simsa	$x_{1}$ is similar/parallel to $x_{2}$ in property/quantity $x_{3}$ (ka/ni); $x_{1}$ looks/appears like $x_{2}$.
simxu	$x_{1}$ (set) has members who mutually/reciprocally $x_{2}$ (event [$x_{1}$ should be reflexive in 1+ sumti]).
since	$x_{1}$ is a snake/serpent of species/breed $x_{2}$.
sinma	$x_{1}$ esteems/respects/venerates/highly regards $x_{2}$ [object of respect].
sinso	$x_{1}$ is the trigonometric sine of angle/arcsine $x_{2}$.
sinxa	$x_{1}$ is a sign/symbol/signal representing/referring/signifying/meaning $x_{2}$ to observer $x_{3}$.
sipna	$x_{1}$ is asleep (adjective); $x_{1}$ sleeps/is sleeping.
sirji	$x_{1}$ is straight/direct/line segment/interval between $x_{2}$ and $x_{3}$; (adjective:)  $x_{1}$ is linear.
sirxo	$x_{1}$ reflects Syrian culture/nationality in aspect $x_{2}$.
sisku	$x_{1}$ seeks/searches/looks for property $x_{2}$ among set $x_{3}$ (complete specification of set).
sisti	$x_{1}$ [agent] ceases/stops/halts/ends activity/process/state $x_{2}$ [not necessarily completing it].
sitna	$x_{1}$ cites/quotes/refers to/makes reference to source $x_{2}$ for information/statement $x_{3}$ (du'u).
sivni	$x_{1}$ is private/personal/privy/[secret/confidential/confined] to $x_{2}$; $x_{1}$ is not-public/hidden.
skaci	$x_{1}$ is a skirt/kilt/dress of material $x_{2}$; $x_{1}$ is skirted [garment open at the bottom; not legged].
skami	$x_{1}$ is a computer for purpose $x_{2}$.
skapi	$x_{1}$ is a pelt/skin/hide/leather from $x_{2}$.
skari	$x_{1}$ is/appears to be of color/hue $x_{2}$ as perceived/seen by $x_{3}$ under conditions $x_{4}$.
skicu	$x_{1}$ tells about/describes $x_{2}$ (object/event/state) to audience $x_{3}$ with description $x_{4}$ (property).
skiji	$x_{1}$ is a ski/skid/skate/runner for surface (of material) $x_{2}$ supporting skier/skater/sled/cargo $x_{3}$.
skina	$x_{1}$ is a cinema/movie/film about $x_{2}$ [plot/theme/subject/activity], filmmaker $x_{3}$, for audience $x_{4}$.
skori	$x_{1}$ is cord/cable/rope/line/twine/cordage/woven strands of material $x_{2}$.
skoto	$x_{1}$ reflects Gaelic/Scottish culture/nationality/language in aspect $x_{2}$.
skuro	$x_{1}$ is a groove/trench/furrow [shape/form] in object/surface $x_{2}$.
slabu	$x_{1}$ is old/familiar/well-known to observer $x_{2}$ in feature $x_{3}$ (ka) by standard $x_{4}$.
slaka	$x_{1}$ is a syllable in language $x_{2}$.
slami	$x_{1}$ is a quantity of/contains/is made of acid of composition $x_{2}$; (adjective:) $x_{1}$ is acidic.
slanu	$x_{1}$ is a cylinder [shape/form] of material $x_{2}$.
slari	$x_{1}$ is sour/tart to observer $x_{2}$.
slasi	$x_{1}$ is a quantity of/is made of/contains plastic/polymer of type/component unit(s) $x_{2}$.
sligu	$x_{1}$ is solid, of composition/material including $x_{2}$, under conditions $x_{3}$.
slilu	$x_{1}$ oscillates at rate/frequency $x_{2}$ through set/sequence-of-states $x_{3}$ (complete specification).
sliri	$x_{1}$ is a quantity of/contains/is made of sulfur/brimstone (S); [metaphor: foul odor, volcanic].
slovo	$x_{1}$ reflects Slavic language/culture/ethos in aspect $x_{2}$.
sluji	$x_{1}$ is a/the muscle [body-part] controlling $x_{2}$, of body $x_{3}$; [metaphor: tools of physical power].
sluni	$x_{1}$ is a quantity of/contains onions/scallions of type/cultivar $x_{2}$.
smacu	$x_{1}$ is a mouse of species/breed $x_{2}$.
smadi	$x_{1}$ guesses/conjectures/surmises $x_{2}$ (du'u) is true about subject $x_{3}$; [epistemology].
smaji	$x_{1}$ (source) is quiet/silent/[still] at observation point $x_{2}$ by standard $x_{3}$.
smani	$x_{1}$ is a monkey/ape/simian/baboon/chimpanzee of species/breed $x_{2}$.
smoka	$x_{1}$ is a sock/stocking [flexible foot and lower leg garment] of material $x_{2}$.
smuci	$x_{1}$ is a spoon/scoop (tool) for use $x_{2}$, made of material $x_{3}$.
smuni	$x_{1}$ is a meaning/interpretation of $x_{2}$ recognized/seen/accepted by $x_{3}$.
snada	$x_{1}$ [agent] succeeds in/achieves/completes/accomplishes $x_{2}$ as a result of effort/attempt/try $x_{3}$.
snanu	$x_{1}$ is to the south/southern side of $x_{2}$ according to frame of reference $x_{3}$.
snidu	$x_{1}$ is $x_{2}$ seconds in duration (default is 1 second) by standard $x_{3}$.
snime	$x_{1}$ is made of/contains/is a quantity/expanse of snow.
snipa	$x_{1}$ adheres/sticks to $x_{2}$; (adjective:) $x_{1}$ is sticky/gummy/adhesive.
snuji	$x_{1}$ is a sandwich/layering [not restricted to food] of $x_{2}$ sandwiched between $x_{3}$.
snura	$x_{1}$ is secure/safe from threat $x_{2}$ (event).
snuti	$x_{1}$ (event/state) is an accident/unintentional on the part of $x_{2}$; $x_{1}$ is an accident.
sobde	$x_{1}$ is a quantity of soya [grain/bean] of species/strain $x_{2}$.
sodna	$x_{1}$ is a quantity of/contains/is made of alkali metal of type $x_{2}$ [default sodium].
sodva	$x_{1}$ is made of/contains/is a quantity of a carbonated beverage/soda of flavor/brand $x_{2}$.
softo	$x_{1}$ reflects Russian empire/USSR/ex-USSR (Soviet]/CIS culture/nationality in aspect $x_{2}$.
solji	$x_{1}$ is a quantity of/contains/is made of gold (Au); [metaphor: valuable, heavy, non-reactive].
solri	$x_{1}$ is the sun of home planet $x_{2}$ (default Earth) of race $x_{3}$; (adjective:) $x_{1}$ is solar.
sombo	$x_{1}$ sows/plants $x_{2}$ [crop/plants] at/in $x_{3}$.
sonci	$x_{1}$ is a soldier/warrior/fighter of army $x_{2}$.
sorcu	$x_{1}$ is a store/deposit/supply/reserve of materials/energy $x_{2}$ in containment $x_{3}$.
sorgu	$x_{1}$ is a quantity of sorghum of species/strain $x_{2}$.
sovda	$x_{1}$ is an egg/ovum/sperm/pollen/gamete of/from organism [mother/father] $x_{2}$.
spaji	$x_{1}$ (event/action abstract) surprises/startles/is unexpected [and generally sudden] to $x_{2}$.
spali	$x_{1}$ (agent) polishes object/surface $x_{2}$ with polish $x_{3}$, applied using tool $x_{4}$.
spano	$x_{1}$ reflects Spanish-speaking culture/nationality/language in aspect $x_{2}$.
spati	$x_{1}$ is a plant/herb/greenery of species/strain/cultivar $x_{2}$.
speni	$x_{1}$ is married to $x_{2}$; $x_{1}$ is a spouse of $x_{2}$ under law/custom/tradition/system/convention $x_{3}$.
spisa	$x_{1}$ [object/substance] is a piece/portion/lump/chunk/particle of $x_{2}$ [substance].
spita	$x_{1}$ is a hospital treating patient(s) $x_{2}$ for condition/injuries/disease/illness $x_{3}$.
spofu	$x_{1}$ is broken/inoperable/broken down/non-utile/not usable for function $x_{2}$.
spoja	$x_{1}$ bursts/explodes/violently breaks up/decomposes/combusts into pieces/energy/fragments $x_{2}$.
spuda	$x_{1}$ answers/replies to/responds to person/object/event/situation/stimulus $x_{2}$ with response $x_{3}$.
sputu	$x_{1}$ spits/expectorates $x_{2}$ [predominantly liquid] from $x_{3}$ to/onto $x_{4}$.
sraji	$x_{1}$ is vertical/upright/erect/plumb/oriented straight up and down in reference frame/gravity $x_{2}$.
sraku	$x_{1}$ [abrasive/cutting/scratching object/implement] scratches/[carves]/erodes/cuts [into] $x_{2}$.
sralo	$x_{1}$ reflects Australian culture/nationality/geography/dialect in aspect $x_{2}$.
srana	$x_{1}$ pertains to/is germane/relevant to/concerns/is related/associated with/is about $x_{2}$.
srasu	$x_{1}$ is a blade/expanse of grass of species $x_{2}$.
srera	$x_{1}$ errs in doing/being/making mistake $x_{2}$ (event), an error under conditions $x_{3}$ by standard $x_{4}$.
srito	$x_{1}$ reflects Sanskrit language/Sanskritic/Vedic culture/nationality in aspect $x_{2}$.
sruma	$x_{1}$ assumes/supposes that $x_{2}$ (du'u) is true about subject $x_{3}$; [epistemology].
sruri	$x_{1}$ encircles/encloses/is surrounding $x_{2}$ in direction(s)/dimension(s)/plane $x_{3}$.
stace	$x_{1}$ is honest/open/truthfully revealing to/candid/frank with $x_{2}$ about matter/fact $x_{3}$.
stagi	$x_{1}$ is the edible $x_{2}$ portion of plant $x_{3}$; $x_{1}$ is a vegetable.
staku	$x_{1}$ is a quantity of/contains/is made of ceramic made by $x_{2}$, of composition $x_{3}$, in form/shape $x_{4}$.
stali	$x_{1}$ remains/stays at/abides/lasts with $x_{2}$.
stani	$x_{1}$ is a/the stalk/stem/trunk [body-part] of plant/species $x_{2}$; [metaphor: main support].
stapa	$x_{1}$ steps/treads on/in surface $x_{2}$ using limbs $x_{3}$.
stasu	$x_{1}$ is a quantity of soup/stew/olla/olio [food] of ingredients including $x_{2}$.
stati	$x_{1}$ has a talent/aptitude/innate skill for doing/being $x_{2}$.
steba	$x_{1}$ feels frustration about $x_{2}$ (abstraction).
steci	$x_{1}$ (ka) is specific/particular/specialized/[special]/a defining property of $x_{2}$ among $x_{3}$ (set).
stedu	$x_{1}$ is a/the head [body-part] of $x_{2}$; [metaphor: uppermost portion].
stela	$x_{1}$ is a lock/seal of/on/for sealing $x_{2}$ with/by locking mechanism $x_{3}$.
stero	$x_{1}$ is $x_{2}$ steradian(s) [metric unit] in solid angle (default is 1) by standard $x_{3}$.
stici	$x_{1}$ is to the west/western side of $x_{2}$ according to frame of reference $x_{3}$.
stidi	$x_{1}$ (agent) suggests/proposes idea/action $x_{2}$ to audience $x_{3}$; $x_{1}$ (event) inspires $x_{2}$ in/among $x_{3}$.
stika	$x_{1}$ (event) adjusts/regulates/changes $x_{2}$ (ka/ni) in amount/degree $x_{3}$.
stizu	$x_{1}$ is a chair/stool/seat/bench, a piece or portion of a piece of furniture intended for sitting.
stodi	$x_{1}$ is constant/invariant/unchanging in property $x_{2}$ (ka) in response to stimulus/conditions $x_{3}$.
stuna	$x_{1}$ is to the east/eastern side of $x_{2}$ according to frame of reference $x_{3}$.
stura	$x_{1}$ is a structure/arrangement/organization of $x_{2}$ [set/system/complexity].
stuzi	$x_{1}$ is an inherent/inalienable site/place/position/situation/spot/location of $x_{2}$ (object/event).
sucta	$x_{1}$ (si'o) is abstracted/generalized/idealized from $x_{2}$ [something concrete] by rules $x_{3}$.
sudga	$x_{1}$ is dry of liquid $x_{2}$; (adjective:) $x_{1}$ is arid.
sufti	$x_{1}$ is a/the hoof [body-part] of $x_{2}$.
suksa	$x_{1}$ (event/state) is sudden/sharply changes at stage/point $x_{2}$ in process/property/function $x_{3}$.
sumji	$x_{1}$ is a mathematical sum/result/total of $x_{2}$ plus/increased by $x_{3}$.
sumne	$x_{1}$ (experiencer) smells/scents (transitive verb) $x_{2}$; $x_{2}$ smells/has odor/scent to observer $x_{1}$.
sumti	$x_{1}$ is a/the argument of predicate/function $x_{2}$ filling place $x_{3}$ (kind/number).
sunga	$x_{1}$ is a quantity of garlic [bulb] of species/strain $x_{2}$.
sunla	$x_{1}$ is a quantity of/made from/consists of wool [tight curly hair] from animal/species/source $x_{2}$.
surla	$x_{1}$ relaxes/rests/is at ease in/by doing/being $x_{2}$ (activity).
sutra	$x_{1}$ is fast/swift/quick/hastes/rapid at doing/being/bringing about $x_{2}$ (event/state).
tabno	$x_{1}$ is a quantity of/contains/is made of carbon/graphite/[diamond]/charcoal; $x_{1}$ is organic.
tabra	$x_{1}$ is a horn/trumpet/trombone/bugle [brass-wind/lip-reed musical instrument].
tadji	$x_{1}$ [process] is a method/technique/approach/means for doing $x_{2}$ (event) under conditions $x_{3}$.
tadni	$x_{1}$ studies/is a student of $x_{2}$; $x_{1}$ is a scholar; (adjective:) $x_{1}$ is scholarly.
tagji	$x_{1}$ is snug/tight on $x_{2}$ in dimension/direction $x_{3}$ at locus $x_{4}$.
talsa	$x_{1}$ (person) challenges $x_{2}$ at/in property $x_{3}$.
tamca	$x_{1}$ is a tomato [fruit/vegetable/plant] of species/strain $x_{2}$.
tamji	$x_{1}$ is a/the thumb/big toe [body-part] on limb $x_{2}$ of $x_{3}$; [metaphor based on relative shape].
tamne	$x_{1}$ is cousin to $x_{2}$ by bond/tie $x_{3}$; [non-immediate family member, default same generation].
tanbo	$x_{1}$ is a board/plank [3-dimensional long flat rectangle] of material $x_{2}$.
tance	$x_{1}$ is a/the tongue [body-part] of $x_{2}$; (metaphor: similar to nazbi, tamji, degji).
tanjo	$x_{1}$ is the trigonometric tangent of angle/arctangent $x_{2}$.
tanko	$x_{1}$ is a quantity of tobacco [leaf] of species/strain $x_{2}$.
tanru	$x_{1}$ is a binary metaphor formed with $x_{2}$ modifying $x_{3}$, giving meaning $x_{4}$ in usage/instance $x_{5}$.
tansi	$x_{1}$ is a pan/basin/tub/sink, a shallow container for contents $x_{2}$, of material/properties $x_{3}$.
tanxe	$x_{1}$ is a box/carton/trunk/crate for contents $x_{2}$, and made of material $x_{3}$.
tapla	$x_{1}$ is a tile/cake [shape/form] of material $x_{2}$, shape $x_{3}$, thickness $x_{4}$.
tarbi	$x_{1}$ is an embryo/zygote/fetus/fertilized egg with mother $x_{2}$, and father $x_{3}$.
tarci	$x_{1}$ is a star/sun with stellar properties $x_{2}$.
tarla	$x_{1}$ is a quantity of/contains/is made of tar/asphalt from source $x_{2}$.
tarmi	$x_{1}$ [ideal] is the conceptual shape/form of object/abstraction/manifestation $x_{2}$ (object/abstract).
tarti	$x_{1}$ behaves/conducts oneself as/in-manner $x_{2}$ (event/property) under conditions $x_{3}$.
taske	$x_{1}$ thirsts for $x_{2}$; $x_{1}$ needs/wants drink/fluid/lubrication $x_{2}$.
tatpi	$x_{1}$ is tired/fatigued by effort/situation $x_{2}$ (event); $x_{1}$ needs/wants rest.
tatru	$x_{1}$ is a/the breast/mammary/teat [body-part] of $x_{2}$; [metaphor: projection providing liquid].
tavla	$x_{1}$ talks/speaks to $x_{2}$ about subject $x_{3}$ in language $x_{4}$.
taxfu	$x_{1}$ is dress/a garment/clothing for wearing by $x_{2}$ (gender/species/body part) serving purpose $x_{3}$.
tcaci	$x_{1}$ is a custom/habit/[ritual/rut] of $x_{2}$ under conditions $x_{3}$.
tcadu	$x_{1}$ is a town/city of metropolitan area $x_{2}$, in political unit $x_{3}$, serving hinterland/region $x_{4}$.
tcana	$x_{1}$ is a station/node of/in/on transport/communication/distribution system/network $x_{2}$.
tcati	$x_{1}$ is made of/contains/is a quantity of tea brewed from leaves $x_{2}$.
tcena	$x_{1}$ stretches/extends to range $x_{2}$ [interval/extent] in dimension $x_{3}$ from relaxed range $x_{4}$.
tcica	$x_{1}$ (event/experience) misleads/deceives/dupes/fools/cheats/tricks $x_{2}$ into $x_{3}$ (event/state).
tcidu	$x_{1}$ [agent] reads $x_{2}$ [text] from surface/document/reading material $x_{3}$; $x_{1}$ is a reader.
tcika	$x_{1}$ [hours, minutes, seconds] is the time/hour of state/event $x_{2}$ on day $x_{3}$ at location $x_{4}$.
tcila	$x_{1}$ is a detail/feature/particular of $x_{2}$.
tcima	$x_{1}$ is weather at place/region $x_{2}$; (adjective:) $x_{1}$ is meteorological.
tcini	$x_{1}$ [state/property] is a situation/condition/state/position/are conditions/circumstances of $x_{2}$.
tcita	$x_{1}$ is a label/tag of $x_{2}$ showing information $x_{3}$.
temci	$x_{1}$ is the time-duration/interval/period/[elapsed time] from time/event $x_{2}$ to time/event $x_{3}$.
tenfa	$x_{1}$ is the exponential result of base $x_{2}$ to power/exponent $x_{3}$.
tengu	$x_{1}$ (property-ka) is a texture of $x_{2}$.
terdi	$x_{1}$ is the Earth/the home planet of race $x_{2}$; (adjective:) $x_{1}$ is terrestrial/earthbound.
terpa	$x_{1}$ fears $x_{2}$; $x_{1}$ is afraid/scared/frightened by/fearful of $x_{2}$ (event/tu'a object).
terto	$x_{1}$ is a trillion [$10^{12}$] of $x_{2}$ in dimension/aspect $x_{3}$ (default is units).
tigni	$x_{1}$ performs $x_{2}$ [performance] for/before audience $x_{3}$.
tikpa	$x_{1}$ kicks [hits with $x_{1}$'s foot/feet $x_{4}$] $x_{2}$ in/at locus $x_{3}$, using $x_{1}$'s foot/feet $x_{4}$.
tilju	$x_{1}$ is heavy/weighty in mass/weight by standard $x_{2}$.
tinbe	$x_{1}$ obeys/follows the command/rule $x_{2}$ made by $x_{3}$; (adjective:) $x_{1}$ is obedient.
tinci	$x_{1}$ is a quantity of/contains/is made of tin (Sn); [metaphor: cheap or base metal].
tinsa	$x_{1}$ is stiff/rigid/inflexible/resistant in direction $x_{2}$ against force $x_{3}$ under conditions $x_{4}$.
tirna	$x_{1}$ hears $x_{2}$ against background/noise $x_{3}$; $x_{2}$ is audible; (adjective:) $x_{1}$ is aural.
tirse	$x_{1}$ is a quantity of/contains/is made of iron (Fe); [metaphor: strong, durable, tarnishing].
tirxu	$x_{1}$ is a tiger/leopard/jaguar/[tigress] of species/breed $x_{2}$ with coat markings $x_{3}$.
tisna	$x_{1}$ (object) fills/becomes stuffed [up]/inflates/blows up with material $x_{2}$; $x_{2}$ pours into $x_{1}$.
titla	$x_{1}$ is sweet/sugary/saccharine to observer $x_{2}$.
tivni	$x_{1}$ broadcasts/televises programming $x_{2}$ via medium/channel $x_{3}$ to television receiver $x_{4}$.
tixnu	$x_{1}$ is a daughter of mother/father/parents $x_{2}$; [not necessarily biological].
toknu	$x_{1}$ is an oven [enclosure that heats its contents] for baking/heating/drying $x_{2}$.
toldi	$x_{1}$ is a butterfly/moth of species/breed $x_{2}$.
tonga	$x_{1}$ is a tone/note of frequency/pitch $x_{2}$ from source $x_{3}$.
tordu	$x_{1}$ is short in dimension/direction $x_{2}$ (default longest dimension) by measurement standard $x_{3}$.
torni	$x_{1}$ twists under load/force/torsion $x_{2}$.
traji	$x_{1}$ is superlative in property $x_{2}$ (ka), the $x_{3}$ extreme (ka; default ka zmadu) among set/range $x_{4}$.
trano	$x_{1}$ is a quantity of/contains/is made of nitrogen/ammonia/nitrates.
trati	$x_{1}$ is taut/tense/strained tight in direction $x_{2}$.
trene	$x_{1}$ is a train [vehicle] of cars/units $x_{2}$ (mass) for rails/system/railroad $x_{3}$, propelled by $x_{4}$.
tricu	$x_{1}$ is a tree of species/cultivar $x_{2}$.
trina	$x_{1}$ attracts/appeals to/lures $x_{2}$ (person/event) with property/quality $x_{3}$ (ka).
trixe	$x_{1}$ is posterior/behind/back/in the rear of $x_{2}$ which faces/in-frame-of-reference $x_{3}$.
troci	$x_{1}$ tries/attempts/makes an effort to do/attain $x_{2}$ (event/state/property) by actions/method $x_{3}$.
tsali	$x_{1}$ is strong/powerful/[tough] in property/quality $x_{2}$ (ka) by standard $x_{3}$.
tsani	$x_{1}$ is an expanse of sky/the heavens at place $x_{2}$; [celestial].
tsapi	$x_{1}$ is a seasoning/condiment/spice causing flavor/effect $x_{2}$ (event/property).
tsiju	$x_{1}$(s) is/are (a) seed(s)/spore(s) [body-part] of organism $x_{2}$ for producing offspring $x_{3}$.
tsina	$x_{1}$ is a stage/platform/dais/[scaffold] at/in $x_{2}$ supporting $x_{3}$, made of material $x_{4}$.
tubnu	$x_{1}$ is a length of tubing/pipe/hollow cylinder [shape/form] of material $x_{2}$, hollow of material $x_{3}$.
tugni	$x_{1}$ [person] agrees with person(s)/position/side $x_{2}$ that $x_{3}$ (du'u) is true about matter $x_{4}$.
tujli	$x_{1}$ is a tulip (defined by flower shape) of species/strain $x_{2}$.
tumla	$x_{1}$ is a parcel/expanse of land at location $x_{2}$; $x_{1}$ is terrain.
tunba	$x_{1}$ is a sibling of $x_{2}$ by bond/tie/standard/parent(s) $x_{3}$.
tunka	$x_{1}$ is made of/contains/is a quantity of copper (Cu); [metaphor: reddish, electrical conductor].
tunlo	$x_{1}$ gulps/swallows.
tunta	$x_{1}$ (object, usually pointed) pokes/jabs/stabs/prods $x_{2}$ (experiencer).
tuple	$x_{1}$ is a/the leg [body-part] of $x_{2}$; [metaphor: supporting branch].
turni	$x_{1}$ governs/rules/is ruler/governor/sovereign/reigns over people/territory/domain/subjects $x_{2}$.
tutci	$x_{1}$ is a tool/utensil/resource/instrument/implement used for doing $x_{2}$; [form determines function].
tutra	$x_{1}$ is territory/domain/space of/belonging to/controlled by $x_{2}$.
vacri	$x_{1}$ is a quantity of air/normally-gaseous atmosphere of planet $x_{2}$, of composition including $x_{3}$.
vajni	$x_{1}$ (object/event) is important/significant to $x_{2}$ (person/event) in aspect/for reason $x_{3}$ (nu/ka).
valsi	$x_{1}$ is a word meaning/causing $x_{2}$ in language $x_{3}$; (adjective: $x_{1}$ is lexical/verbal).
vamji	$x_{1}$ (ni) is the equivalent value/worth of $x_{2}$ [item(s) of value] to $x_{3}$ for use/appreciation $x_{4}$.
vamtu	$x_{1}$ vomits/regurgitates $x_{2}$; $x_{1}$ throws $x_{2}$ up; [violent] digestive expulsion.
vanbi	$x_{1}$ (ind./mass) is part of an environment/surroundings/context/ambience of $x_{2}$.
vanci	$x_{1}$ is an evening [from end-of-work until sleep typical for locale] of day $x_{2}$ at location $x_{3}$.
vanju	$x_{1}$ is made of/contains/is a quantity of wine from fruit/grapes $x_{2}$.
vasru	$x_{1}$ contains/holds/encloses/includes contents $x_{2}$ within; $x_{1}$ is a vessel containing $x_{2}$.
vasxu	$x_{1}$ breathes/respires $x_{2}$ [gas].
vecnu	$x_{1}$ [seller] sells/vends $x_{2}$ [goods/service/commodity] to buyer $x_{3}$ for amount/cost/expense $x_{4}$.
venfu	$x_{1}$ takes revenge on/retaliates against $x_{2}$ (person) for wrong $x_{3}$ (nu) with vengeance $x_{4}$ (nu).
vensa	$x_{1}$ is spring/springtime [warming season] of year $x_{2}$ at location $x_{3}$; (adjective:) $x_{1}$ is vernal.
verba	$x_{1}$ is a child/kid/juvenile [a young person] of age $x_{2}$, immature by standard $x_{3}$.
vibna	$x_{1}$ is a/the vagina [body-part] of $x_{2}$.
vidni	$x_{1}$ is a video monitor/CRT/screen [machine] serving function $x_{2}$.
vidru	$x_{1}$ is a virus of species/breed/defining property $x_{2}$ capable of infecting [at] $x_{3}$.
vifne	(adjective:) $x_{1}$ is fresh/unspoiled.
vikmi	$x_{1}$ [body] excretes waste $x_{2}$ from source $x_{3}$ via means/route $x_{4}$.
viknu	$x_{1}$ is thick/viscous under conditions $x_{2}$.
vimcu	$x_{1}$ removes/subtracts/deducts/takes away $x_{2}$ from $x_{3}$ with/leaving result/remnant/remainder $x_{4}$.
vindu	$x_{1}$ is poisonous/venomous/toxic/a toxin to $x_{2}$.
vinji	$x_{1}$ is an airplane/aircraft [flying vehicle] for carrying passengers/cargo $x_{2}$, propelled by $x_{3}$.
vipsi	$x_{1}$ is a deputy/vice/subordinate in aspect [or organization principle] $x_{2}$ (ka) to principal $x_{3}$.
virnu	$x_{1}$ is brave/valiant/courageous in activity $x_{2}$ (event) by standard $x_{3}$.
viska	$x_{1}$ sees/views/perceives visually $x_{2}$ under conditions $x_{3}$.
vitci	$x_{1}$ is irregular/occasional/intermittent in property/action/aspect $x_{2}$.
vitke	$x_{1}$ is a guest/visitor of $x_{2}$ at place/event $x_{3}$; $x_{1}$ visits $x_{2}$/$x_{3}$.
vitno	$x_{1}$ is permanent/lasting/[eternal] in property $x_{2}$ (ka) by standard $x_{3}$ [time-span/expectant one].
vlagi	$x_{1}$ is a/the vulva [body-part] of $x_{2}$.
vlile	$x_{1}$ is an event/state/act of violence.
vlina	$x_{1}$ is a logical alternation/disjunction, stating that $x_{2}$ (du'u) and/or $x_{3}$ (du'u) is/are true.
vlipa	$x_{1}$ has the power to bring about $x_{2}$ under conditions $x_{3}$; $x_{1}$ is powerful in aspect $x_{2}$ under $x_{3}$.
vofli	$x_{1}$ flies [in air/atmosphere] using lifting/propulsion means $x_{2}$.
voksa	$x_{1}$ is a voice/speech sound of individual $x_{2}$.
vorme	$x_{1}$ is a doorway/gateway/access way between $x_{2}$ and $x_{3}$ of structure $x_{4}$.
vraga	$x_{1}$ is a lever [tool] [of apparatus] for doing $x_{2}$ [function/action], with fulcrum $x_{3}$ and arm $x_{4}$.
vreji	$x_{1}$ is a record of $x_{2}$ (data/facts/du'u) about $x_{3}$ (object/event) preserved in medium $x_{4}$.
vreta	$x_{1}$ lies/rests/reclines/reposes on $x_{2}$; $x_{1}$ is reclining/recumbent/lying on $x_{2}$.
vrici	$x_{1}$ (set/mass/ind.) is miscellaneous/various/assorted in property $x_{2}$ (ka).
vrude	$x_{1}$ is virtuous/saintly/[fine/moral/nice/holy/morally good] by standard $x_{2}$.
vrusi	$x_{1}$ (ka) is a taste/flavor of/emitted by $x_{2}$; $x_{2}$ tastes of/like $x_{1}$.
vukro	$x_{1}$ reflects Ukrainian language/culture/nationality in aspect $x_{2}$.
xabju	$x_{1}$ dwells/lives/resides/abides at/inhabits/is a resident of location/habitat/nest/home/abode $x_{2}$.
xadba	$x_{1}$ is exactly/approximately half/semi-/demi-/hemi- of $x_{2}$ by standard $x_{3}$.
xadni	$x_{1}$ is a/the body/corpus/corpse of $x_{2}$; (adjective:) $x_{1}$ is corporal/corporeal.
xagji	$x_{1}$ hungers for $x_{2}$; $x_{1}$ needs/wants food/fuel $x_{2}$.
xagri	$x_{1}$ is a oboe/clarinet/saxophone [reed musical instrument] with reed $x_{2}$.
xajmi	$x_{1}$ is funny/comical to $x_{2}$ in property/aspect $x_{3}$ (nu/ka); $x_{3}$ is what is funny about $x_{1}$ to $x_{2}$.
xaksu	$x_{1}$ (event) uses up/depletes/consumes/[wastes] $x_{2}$ [resource].
xalbo	$x_{1}$ uses levity/is non-serious/frivolous about $x_{2}$ (abstraction).
xalka	$x_{1}$ is a quantity of/contains/is made of alcohol of type $x_{2}$ from source/process $x_{3}$.
xalni	$x_{1}$ (person) is panicked by crisis $x_{2}$ (event/state).
xamgu	$x_{1}$ (object/event) is good/beneficial/nice/[acceptable] for $x_{2}$ by standard $x_{3}$.
xampo	$x_{1}$ is $x_{2}$ ampere(s) [metric unit] in current (default is 1) by standard $x_{3}$.
xamsi	$x_{1}$ is a sea/ocean/gulf/[atmosphere] of planet $x_{2}$, of fluid $x_{3}$; (adjective:) $x_{1}$ is marine.
xance	$x_{1}$ is a/the hand [body-part] of $x_{2}$; [metaphor: manipulating tool, waldo].
xanka	$x_{1}$ is nervous/anxious about $x_{2}$ (abstraction) under conditions $x_{3}$.
xanri	$x_{1}$ [concept] exists in the imagination of/is imagined by/is imaginary to $x_{2}$.
xanto	$x_{1}$ is an elephant of species/breed $x_{2}$.
xarci	$x_{1}$ is a weapon/arms for use against $x_{2}$ by $x_{3}$.
xarju	$x_{1}$ is a pig/hog/swine/[boar] [pork/ham/bacon-producer] of species/breed $x_{2}$.
xarnu	$x_{1}$ is stubborn/willfully opposing/resisting $x_{2}$ about $x_{3}$ (event/state).
xasli	$x_{1}$ is a donkey/jackass of species/breed $x_{2}$.
xasne	$x_{1}$ is a/the sweat/perspiration from body $x_{2}$, excreted by gland(s)/organs $x_{3}$.
xatra	$x_{1}$ is a letter/missive/[note] to intended audience $x_{2}$ from author/originator $x_{3}$ with content $x_{4}$.
xatsi	$x_{1}$ is $10^{-18}$ of $x_{2}$ in dimension/aspect $x_{3}$ (default is units).
xazdo	$x_{1}$ reflects Asiatic culture/nationality/geography in aspect $x_{2}$.
xebni	$x_{1}$ hates/despises $x_{2}$ (object/abstraction); $x_{1}$ is full of hate for $x_{2}$; $x_{2}$ is odious to $x_{1}$.
xebro	$x_{1}$ reflects Hebrew/Jewish/Israeli culture/nationality/language in aspect $x_{2}$.
xecto	$x_{1}$ is a hundred [100; $10^2$] of $x_{2}$ in dimension/aspect $x_{3}$ (default is units).
xedja	$x_{1}$ is a/the jaw [body-part] of $x_{2}$.
xekri	$x_{1}$ is black/extremely dark-colored [color adjective].
xelso	$x_{1}$ reflects Greek/Hellenic culture/nationality/language in aspect $x_{2}$.
xendo	$x_{1}$ (person) is kind to $x_{2}$ in actions/behavior $x_{3}$.
xenru	$x_{1}$ regrets/rues (abstraction) $x_{2}$; $x_{1}$ is regretful/rueful/sorry/[remorseful] about $x_{2}$.
xexso	$x_{1}$ is $10^{18}$ of $x_{2}$ in dimension/aspect $x_{3}$ (default is units).
xindo	$x_{1}$ reflects Hindi language/culture/religion in aspect $x_{2}$.
xinmo	$x_{1}$ is a quantity of ink of color/pigment $x_{2}$ used by writing device $x_{3}$.
xirma	$x_{1}$ is a horse/equine/[colt/mare/stallion/pony] of species/breed $x_{2}$.
xislu	$x_{1}$ is a wheel [tool] of device/vehicle $x_{2}$, made of materials/having properties $x_{3}$.
xispo	$x_{1}$ reflects Hispano-American culture/nationalities in aspect $x_{2}$.
xlali	$x_{1}$ is bad for $x_{2}$ by standard $x_{3}$; $x_{1}$ is poor/unacceptable to $x_{2}$.
xlura	$x_{1}$ (agent) influences/lures/tempts $x_{2}$ into action/state $x_{3}$ by influence/threat/lure $x_{4}$.
xotli	$x_{1}$ is a hotel/inn/hostel at location $x_{2}$ operated by $x_{3}$.
xrabo	$x_{1}$ reflects Arabic-speaking culture/nationality in aspect $x_{2}$.
xrani	$x_{1}$ (event) injures/harms/damages victim $x_{2}$ in property $x_{3}$ (ka) resulting in injury $x_{4}$ (state).
xriso	$x_{1}$ pertains to the Christian religion/culture/nationality in aspect $x_{2}$.
xruba	$x_{1}$ is a quantity of buckwheat/rhubarb/sorrel grass of species/strain $x_{2}$.
xruki	$x_{1}$ is a turkey [food/bird] of species/breed $x_{2}$.
xrula	$x_{1}$ is a/the flower/blossom/bloom [body-part] of plant/species $x_{2}$; (adjective:) $x_{1}$ is floral.
xruti	$x_{1}$ (agent) returns $x_{2}$ to origin/earlier state $x_{3}$ from $x_{4}$; $x_{1}$ moves/gives $x_{2}$ back to $x_{3}$ from $x_{4}$.
xukmi	$x_{1}$ is an instance of substance/chemical/drug $x_{2}$ (individual or mass) with purity $x_{3}$.
xunre	$x_{1}$ is red/crimson/ruddy [color adjective].
xurdo	$x_{1}$ reflects Urdu language/culture/nationality in aspect $x_{2}$.
xusra	$x_{1}$ (agent) asserts/claims/declares $x_{2}$ (du'u) is true [can be used for epistemology of authority].
xutla	$x_{1}$ is smooth/even/[soft/silky] in texture/regularity.
zabna	$x_1$ is favorable/great/superb/fabulous/dandy/outstanding/swell/admirable/nice/commendable/delightful/desirable/enjoyable/laudable/likable/lovable/wonderful/praiseworthy/high-quality/cool in property $x_2$ by standard $x_3$; $x_1$ rocks in aspect $x_2$ according to $x_3$
zajba	$x_{1}$ is a gymnast at/performs gymnastics feat $x_{2}$.
zalvi	$x_{1}$ [individual or mass of hard surfaces] grinds/pulverizes/crushes $x_{2}$ into powder $x_{3}$.
zanru	$x_{1}$ approves of/gives favor to plan/action $x_{2}$ (object/event).
zarci	$x_{1}$ is a market/store/exchange/shop(s) selling/trading (for) $x_{2}$, operated by/with participants $x_{3}$.
zargu	$x_{1}$ is a/the buttock(s)/arse/rear/seat [body-part] of $x_{2}$; [metaphor: rounded surface, support].
zasni	$x_{1}$ is temporary/not permanent/expected to change in property $x_{2}$ (ka) by standard/expectant $x_{3}$.
zasti	$x_{1}$ exists/is real/actual/reality for $x_{2}$ under metaphysics $x_{3}$.
zbabu	$x_{1}$ is a quantity of/contains/is made of soap from source $x_{2}$ of composition including $x_{3}$.
zbani	$x_{1}$ is a bay in/of coast/shoreline $x_{2}$.
zbasu	$x_{1}$ makes/assembles/builds/manufactures/creates $x_{2}$ out of materials/parts/components $x_{3}$.
zbepi	$x_{1}$ is a pedestal/base/stand/pallet supporting $x_{2}$ (object/event), of materials/properties $x_{3}$.
zdani	$x_{1}$ is a nest/house/lair/den/[home] of/for $x_{2}$.
zdile	$x_{1}$ (abstract) is amusing/entertaining to $x_{2}$ in property/aspect $x_{3}$; $x_{3}$ is what amuses $x_{2}$ about $x_{1}$.
zekri	$x_{1}$ (event/state) is a punishable crime/[taboo/sin] to people/culture/judges/jury $x_{2}$.
zenba	$x_{1}$ (experiencer) increases/is incremented/augmented in property/quantity $x_{2}$ by amount $x_{3}$.
zepti	$x_{1}$ is $10^{-21}$ of $x_{2}$ in dimension/aspect $x_{3}$ (default is units).
zetro	$x_{1}$ is $10^{21}$ of $x_{2}$ in dimension/aspect $x_{3}$ (default is units).
zgana	$x_{1}$ observes/[notices]/watches/beholds $x_{2}$ using senses/means $x_{3}$ under conditions $x_{4}$.
zgike	$x_{1}$ is music performed/produced by $x_{2}$ (event).
zifre	$x_{1}$ is free/at liberty to do/be $x_{2}$ (event/state) under conditions $x_{3}$.
zinki	$x_{1}$ is a quantity of/contains/is made of zinc (Zn); [metaphor: hard metal].
zirpu	$x_{1}$ is purple/violet [color adjective].
zivle	$x_{1}$ (agent) invests resources $x_{2}$ in investment $x_{3}$ expecting return/profit $x_{4}$ (object(s)/event).
zmadu	$x_{1}$ exceeds/is more than $x_{2}$ in property/quantity $x_{3}$ (ka/ni) by amount/excess $x_{4}$.
zmiku	$x_{1}$ is automatic in function $x_{2}$ under conditions $x_{3}$.
zukte	$x_{1}$ is a volitional entity employing means/taking action $x_{2}$ for purpose/goal $x_{3}$/to end $x_{3}$.
zumri	$x_{1}$ is a quantity of maize/corn [grain] of species/strain $x_{2}$.
zungi	$x_{1}$ feels guilt/remorse about $x_{2}$ (abstraction).
zunle	$x_{1}$ is to the left/left-hand side of $x_{2}$ which faces/in-frame-of-reference $x_{3}$.
zunti	$x_{1}$ (evt./state) interferes with/hinders/disrupts $x_{2}$ (evt./state/process) due to quality $x_{3}$ (ka).
zutse	$x_{1}$ sits [assumes sitting position] on surface $x_{2}$.
zvati	$x_{1}$ (object/event) is at/attending/present at $x_{2}$ (event/location).